AA(degree=comp,position=free)	AA(degree=comp,position=free)	AA(degree=comp,position=free)
AA(degree=comp,position=free,WF=abbr)	AA(degree=comp,position=free,WF=abbr)	AA(degree=comp,position=free,WF=abbr)
AA(degree=comp,position=free,WF=mis)	AA(degree=comp,position=free,WF=mis)	AA(degree=comp,position=free,WF=mis)
AA(degree=comp,position=free,WF=trunc)	AA(degree=comp,position=free,WF=trunc)	AA(degree=comp,position=free,WF=trunc)
AA(degree=comp,position=postnom)	AA(degree=comp,position=postnom)	AA(degree=comp,position=postnom)
AA(degree=comp,position=postnom,WF=abbr)	AA(degree=comp,position=postnom,WF=abbr)	AA(degree=comp,position=postnom,WF=abbr)
AA(degree=comp,position=postnom,WF=mis)	AA(degree=comp,position=postnom,WF=mis)	AA(degree=comp,position=postnom,WF=mis)
AA(degree=comp,position=postnom,WF=trunc)	AA(degree=comp,position=postnom,WF=trunc)	AA(degree=comp,position=postnom,WF=trunc)
AA(degree=comp,position=prenom)	AA(degree=comp,position=prenom)	AA(degree=comp,position=prenom)
AA(degree=comp,position=prenom,WF=abbr)	AA(degree=comp,position=prenom,WF=abbr)	AA(degree=comp,position=prenom,WF=abbr)
AA(degree=comp,position=prenom,WF=mis)	AA(degree=comp,position=prenom,WF=mis)	AA(degree=comp,position=prenom,WF=mis)
AA(degree=comp,position=prenom,WF=trunc)	AA(degree=comp,position=prenom,WF=trunc)	AA(degree=comp,position=prenom,WF=trunc)
AA(degree=comp,position=uncl)	AA(degree=comp,position=uncl)	AA(degree=comp,position=uncl)
AA(degree=comp,position=uncl,WF=abbr)	AA(degree=comp,position=uncl,WF=abbr)	AA(degree=comp,position=uncl,WF=abbr)
AA(degree=comp,position=uncl,WF=mis)	AA(degree=comp,position=uncl,WF=mis)	AA(degree=comp,position=uncl,WF=mis)
AA(degree=comp,position=uncl,WF=trunc)	AA(degree=comp,position=uncl,WF=trunc)	AA(degree=comp,position=uncl,WF=trunc)
AA(degree=pos,position=free)	AA(degree=pos,position=free)	AA(degree=pos,position=free)
AA(degree=pos,position=free,WF=abbr)	AA(degree=pos,position=free,WF=abbr)	AA(degree=pos,position=free,WF=abbr)
AA(degree=pos,position=free,WF=mis)	AA(degree=pos,position=free,WF=mis)	AA(degree=pos,position=free,WF=mis)
AA(degree=pos,position=free,WF=trunc)	AA(degree=pos,position=free,WF=trunc)	AA(degree=pos,position=free,WF=trunc)
AA(degree=pos,position=postnom)	AA(degree=pos,position=postnom)	AA(degree=pos,position=postnom)
AA(degree=pos,position=postnom,WF=abbr)	AA(degree=pos,position=postnom,WF=abbr)	AA(degree=pos,position=postnom,WF=abbr)
AA(degree=pos,position=postnom,WF=mis)	AA(degree=pos,position=postnom,WF=mis)	AA(degree=pos,position=postnom,WF=mis)
AA(degree=pos,position=postnom,WF=trunc)	AA(degree=pos,position=postnom,WF=trunc)	AA(degree=pos,position=postnom,WF=trunc)
AA(degree=pos,position=prenom)	AA(degree=pos,position=prenom)	AA(degree=pos,position=prenom)
AA(degree=pos,position=prenom,WF=abbr)	AA(degree=pos,position=prenom,WF=abbr)	AA(degree=pos,position=prenom,WF=abbr)
AA(degree=pos,position=prenom,WF=mis)	AA(degree=pos,position=prenom,WF=mis)	AA(degree=pos,position=prenom,WF=mis)
AA(degree=pos,position=prenom,WF=trunc)	AA(degree=pos,position=prenom,WF=trunc)	AA(degree=pos,position=prenom,WF=trunc)
AA(degree=pos,position=uncl)	AA(degree=pos,position=uncl)	AA(degree=pos,position=uncl)
AA(degree=pos,position=uncl,WF=abbr)	AA(degree=pos,position=uncl,WF=abbr)	AA(degree=pos,position=uncl,WF=abbr)
AA(degree=pos,position=uncl,WF=mis)	AA(degree=pos,position=uncl,WF=mis)	AA(degree=pos,position=uncl,WF=mis)
AA(degree=pos,position=uncl,WF=trunc)	AA(degree=pos,position=uncl,WF=trunc)	AA(degree=pos,position=uncl,WF=trunc)
AA(degree=sup,position=free)	AA(degree=sup,position=free)	AA(degree=sup,position=free)
AA(degree=sup,position=free,WF=abbr)	AA(degree=sup,position=free,WF=abbr)	AA(degree=sup,position=free,WF=abbr)
AA(degree=sup,position=free,WF=mis)	AA(degree=sup,position=free,WF=mis)	AA(degree=sup,position=free,WF=mis)
AA(degree=sup,position=free,WF=trunc)	AA(degree=sup,position=free,WF=trunc)	AA(degree=sup,position=free,WF=trunc)
AA(degree=sup,position=postnom)	AA(degree=sup,position=postnom)	AA(degree=sup,position=postnom)
AA(degree=sup,position=postnom,WF=abbr)	AA(degree=sup,position=postnom,WF=abbr)	AA(degree=sup,position=postnom,WF=abbr)
AA(degree=sup,position=postnom,WF=mis)	AA(degree=sup,position=postnom,WF=mis)	AA(degree=sup,position=postnom,WF=mis)
AA(degree=sup,position=postnom,WF=trunc)	AA(degree=sup,position=postnom,WF=trunc)	AA(degree=sup,position=postnom,WF=trunc)
AA(degree=sup,position=prenom)	AA(degree=sup,position=prenom)	AA(degree=sup,position=prenom)
AA(degree=sup,position=prenom,WF=abbr)	AA(degree=sup,position=prenom,WF=abbr)	AA(degree=sup,position=prenom,WF=abbr)
AA(degree=sup,position=prenom,WF=mis)	AA(degree=sup,position=prenom,WF=mis)	AA(degree=sup,position=prenom,WF=mis)
AA(degree=sup,position=prenom,WF=trunc)	AA(degree=sup,position=prenom,WF=trunc)	AA(degree=sup,position=prenom,WF=trunc)
AA(degree=sup,position=uncl)	AA(degree=sup,position=uncl)	AA(degree=sup,position=uncl)
AA(degree=sup,position=uncl,WF=abbr)	AA(degree=sup,position=uncl,WF=abbr)	AA(degree=sup,position=uncl,WF=abbr)
AA(degree=sup,position=uncl,WF=mis)	AA(degree=sup,position=uncl,WF=mis)	AA(degree=sup,position=uncl,WF=mis)
AA(degree=sup,position=uncl,WF=trunc)	AA(degree=sup,position=uncl,WF=trunc)	AA(degree=sup,position=uncl,WF=trunc)
AA(degree=uncl,position=free)	AA(degree=uncl,position=free)	AA(degree=uncl,position=free)
AA(degree=uncl,position=free,WF=abbr)	AA(degree=uncl,position=free,WF=abbr)	AA(degree=uncl,position=free,WF=abbr)
AA(degree=uncl,position=free,WF=mis)	AA(degree=uncl,position=free,WF=mis)	AA(degree=uncl,position=free,WF=mis)
AA(degree=uncl,position=free,WF=trunc)	AA(degree=uncl,position=free,WF=trunc)	AA(degree=uncl,position=free,WF=trunc)
AA(degree=uncl,position=postnom)	AA(degree=uncl,position=postnom)	AA(degree=uncl,position=postnom)
AA(degree=uncl,position=postnom,WF=abbr)	AA(degree=uncl,position=postnom,WF=abbr)	AA(degree=uncl,position=postnom,WF=abbr)
AA(degree=uncl,position=postnom,WF=mis)	AA(degree=uncl,position=postnom,WF=mis)	AA(degree=uncl,position=postnom,WF=mis)
AA(degree=uncl,position=postnom,WF=trunc)	AA(degree=uncl,position=postnom,WF=trunc)	AA(degree=uncl,position=postnom,WF=trunc)
AA(degree=uncl,position=prenom)	AA(degree=uncl,position=prenom)	AA(degree=uncl,position=prenom)
AA(degree=uncl,position=prenom,WF=abbr)	AA(degree=uncl,position=prenom,WF=abbr)	AA(degree=uncl,position=prenom,WF=abbr)
AA(degree=uncl,position=prenom,WF=mis)	AA(degree=uncl,position=prenom,WF=mis)	AA(degree=uncl,position=prenom,WF=mis)
AA(degree=uncl,position=prenom,WF=trunc)	AA(degree=uncl,position=prenom,WF=trunc)	AA(degree=uncl,position=prenom,WF=trunc)
AA(degree=uncl,position=uncl)	AA(degree=uncl,position=uncl)	AA(degree=uncl,position=uncl)
AA(degree=uncl,position=uncl,WF=abbr)	AA(degree=uncl,position=uncl,WF=abbr)	AA(degree=uncl,position=uncl,WF=abbr)
AA(degree=uncl,position=uncl,WF=mis)	AA(degree=uncl,position=uncl,WF=mis)	AA(degree=uncl,position=uncl,WF=mis)
AA(degree=uncl,position=uncl,WF=trunc)	AA(degree=uncl,position=uncl,WF=trunc)	AA(degree=uncl,position=uncl,WF=trunc)
ADP(type=circ)	ADP(type=circ)	ADP(type=circ)
ADP(type=circ,WF=abbr)	ADP(type=circ,WF=abbr)	ADP(type=circ,WF=abbr)
ADP(type=circ,WF=mis)	ADP(type=circ,WF=mis)	ADP(type=circ,WF=mis)
ADP(type=circ,WF=trunc)	ADP(type=circ,WF=trunc)	ADP(type=circ,WF=trunc)
ADP(type=post)	ADP(type=post)	ADP(type=post)
ADP(type=post,WF=abbr)	ADP(type=post,WF=abbr)	ADP(type=post,WF=abbr)
ADP(type=post,WF=mis)	ADP(type=post,WF=mis)	ADP(type=post,WF=mis)
ADP(type=post,WF=trunc)	ADP(type=post,WF=trunc)	ADP(type=post,WF=trunc)
ADP(type=pre)	ADP(type=pre)	ADP(type=pre)
ADP(type=pre,WF=abbr)	ADP(type=pre,WF=abbr)	ADP(type=pre,WF=abbr)
ADP(type=pre,WF=mis)	ADP(type=pre,WF=mis)	ADP(type=pre,WF=mis)
ADP(type=pre,WF=trunc)	ADP(type=pre,WF=trunc)	ADP(type=pre,WF=trunc)
ADP(type=uncl)	ADP(type=uncl)	ADP(type=uncl)
ADP(type=uncl,WF=abbr)	ADP(type=uncl,WF=abbr)	ADP(type=uncl,WF=abbr)
ADP(type=uncl,WF=mis)	ADP(type=uncl,WF=mis)	ADP(type=uncl,WF=mis)
ADP(type=uncl,WF=trunc)	ADP(type=uncl,WF=trunc)	ADP(type=uncl,WF=trunc)
ADV(type=pron)	ADV(type=pron)	ADV(type=pron)
ADV(type=pron,WF=abbr)	ADV(type=pron,WF=abbr)	ADV(type=pron,WF=abbr)
ADV(type=pron,WF=mis)	ADV(type=pron,WF=mis)	ADV(type=pron,WF=mis)
ADV(type=pron,WF=trunc)	ADV(type=pron,WF=trunc)	ADV(type=pron,WF=trunc)
ADV(type=reg)	ADV(type=reg)	ADV(type=reg)
ADV(type=reg,WF=abbr)	ADV(type=reg,WF=abbr)	ADV(type=reg,WF=abbr)
ADV(type=reg,WF=mis)	ADV(type=reg,WF=mis)	ADV(type=reg,WF=mis)
ADV(type=reg,WF=trunc)	ADV(type=reg,WF=trunc)	ADV(type=reg,WF=trunc)
ADV(type=uncl)	ADV(type=uncl)	ADV(type=uncl)
ADV(type=uncl,WF=abbr)	ADV(type=uncl,WF=abbr)	ADV(type=uncl,WF=abbr)
ADV(type=uncl,WF=mis)	ADV(type=uncl,WF=mis)	ADV(type=uncl,WF=mis)
ADV(type=uncl,WF=trunc)	ADV(type=uncl,WF=trunc)	ADV(type=uncl,WF=trunc)
CONJ(type=coor)	CONJ(type=coor)	CONJ(type=coor)
CONJ(type=coor,WF=abbr)	CONJ(type=coor,WF=abbr)	CONJ(type=coor,WF=abbr)
CONJ(type=coor,WF=mis)	CONJ(type=coor,WF=mis)	CONJ(type=coor,WF=mis)
CONJ(type=coor,WF=trunc)	CONJ(type=coor,WF=trunc)	CONJ(type=coor,WF=trunc)
CONJ(type=sub)	CONJ(type=sub)	CONJ(type=sub)
CONJ(type=sub,WF=abbr)	CONJ(type=sub,WF=abbr)	CONJ(type=sub,WF=abbr)
CONJ(type=sub,WF=mis)	CONJ(type=sub,WF=mis)	CONJ(type=sub,WF=mis)
CONJ(type=sub,WF=trunc)	CONJ(type=sub,WF=trunc)	CONJ(type=sub,WF=trunc)
CONJ(type=uncl)	CONJ(type=uncl)	CONJ(type=uncl)
CONJ(type=uncl,WF=abbr)	CONJ(type=uncl,WF=abbr)	CONJ(type=uncl,WF=abbr)
CONJ(type=uncl,WF=mis)	CONJ(type=uncl,WF=mis)	CONJ(type=uncl,WF=mis)
CONJ(type=uncl,WF=trunc)	CONJ(type=uncl,WF=trunc)	CONJ(type=uncl,WF=trunc)
INT()	INT()	INT()
INT(WF=abbr)	INT(WF=abbr)	INT(WF=abbr)
INT(WF=mis)	INT(WF=mis)	INT(WF=mis)
INT(WF=trunc)	INT(WF=trunc)	INT(WF=trunc)
NOU-C(number=pl)	NOU-C(number=pl)	NOU-C(number=pl)
NOU-C(number=pl,WF=abbr)	NOU-C(number=pl,WF=abbr)	NOU-C(number=pl,WF=abbr)
NOU-C(number=pl,WF=mis)	NOU-C(number=pl,WF=mis)	NOU-C(number=pl,WF=mis)
NOU-C(number=pl,WF=trunc)	NOU-C(number=pl,WF=trunc)	NOU-C(number=pl,WF=trunc)
NOU-C(number=sg)	NOU-C(number=sg)	NOU-C(number=sg)
NOU-C(number=sg,WF=abbr)	NOU-C(number=sg,WF=abbr)	NOU-C(number=sg,WF=abbr)
NOU-C(number=sg,WF=mis)	NOU-C(number=sg,WF=mis)	NOU-C(number=sg,WF=mis)
NOU-C(number=sg,WF=trunc)	NOU-C(number=sg,WF=trunc)	NOU-C(number=sg,WF=trunc)
NOU-C(number=uncl)	NOU-C(number=uncl)	NOU-C(number=uncl)
NOU-C(number=uncl,WF=abbr)	NOU-C(number=uncl,WF=abbr)	NOU-C(number=uncl,WF=abbr)
NOU-C(number=uncl,WF=mis)	NOU-C(number=uncl,WF=mis)	NOU-C(number=uncl,WF=mis)
NOU-C(number=uncl,WF=trunc)	NOU-C(number=uncl,WF=trunc)	NOU-C(number=uncl,WF=trunc)
NOU-P()	NOU-P()	NOU-P()
NUM(type=card,position=free,representation=dig)	NUM(type=card,position=free,representation=dig)	NUM(type=card,position=free,representation=dig)
NUM(type=card,position=free,representation=dig,WF=abbr)	NUM(type=card,position=free,representation=dig,WF=abbr)	NUM(type=card,position=free,representation=dig,WF=abbr)
NUM(type=card,position=free,representation=dig,WF=mis)	NUM(type=card,position=free,representation=dig,WF=mis)	NUM(type=card,position=free,representation=dig,WF=mis)
NUM(type=card,position=free,representation=dig,WF=trunc)	NUM(type=card,position=free,representation=dig,WF=trunc)	NUM(type=card,position=free,representation=dig,WF=trunc)
NUM(type=card,position=free,representation=let)	NUM(type=card,position=free,representation=let)	NUM(type=card,position=free,representation=let)
NUM(type=card,position=free,representation=let,WF=abbr)	NUM(type=card,position=free,representation=let,WF=abbr)	NUM(type=card,position=free,representation=let,WF=abbr)
NUM(type=card,position=free,representation=let,WF=mis)	NUM(type=card,position=free,representation=let,WF=mis)	NUM(type=card,position=free,representation=let,WF=mis)
NUM(type=card,position=free,representation=let,WF=trunc)	NUM(type=card,position=free,representation=let,WF=trunc)	NUM(type=card,position=free,representation=let,WF=trunc)
NUM(type=card,position=free,representation=mix-dig)	NUM(type=card,position=free,representation=mix-dig)	NUM(type=card,position=free,representation=mix-dig)
NUM(type=card,position=free,representation=mix-dig,WF=abbr)	NUM(type=card,position=free,representation=mix-dig,WF=abbr)	NUM(type=card,position=free,representation=mix-dig,WF=abbr)
NUM(type=card,position=free,representation=mix-dig,WF=mis)	NUM(type=card,position=free,representation=mix-dig,WF=mis)	NUM(type=card,position=free,representation=mix-dig,WF=mis)
NUM(type=card,position=free,representation=mix-dig,WF=trunc)	NUM(type=card,position=free,representation=mix-dig,WF=trunc)	NUM(type=card,position=free,representation=mix-dig,WF=trunc)
NUM(type=card,position=free,representation=mix-rom)	NUM(type=card,position=free,representation=mix-rom)	NUM(type=card,position=free,representation=mix-rom)
NUM(type=card,position=free,representation=mix-rom,WF=abbr)	NUM(type=card,position=free,representation=mix-rom,WF=abbr)	NUM(type=card,position=free,representation=mix-rom,WF=abbr)
NUM(type=card,position=free,representation=mix-rom,WF=mis)	NUM(type=card,position=free,representation=mix-rom,WF=mis)	NUM(type=card,position=free,representation=mix-rom,WF=mis)
NUM(type=card,position=free,representation=mix-rom,WF=trunc)	NUM(type=card,position=free,representation=mix-rom,WF=trunc)	NUM(type=card,position=free,representation=mix-rom,WF=trunc)
NUM(type=card,position=free,representation=rom)	NUM(type=card,position=free,representation=rom)	NUM(type=card,position=free,representation=rom)
NUM(type=card,position=free,representation=rom,WF=abbr)	NUM(type=card,position=free,representation=rom,WF=abbr)	NUM(type=card,position=free,representation=rom,WF=abbr)
NUM(type=card,position=free,representation=rom,WF=mis)	NUM(type=card,position=free,representation=rom,WF=mis)	NUM(type=card,position=free,representation=rom,WF=mis)
NUM(type=card,position=free,representation=rom,WF=trunc)	NUM(type=card,position=free,representation=rom,WF=trunc)	NUM(type=card,position=free,representation=rom,WF=trunc)
NUM(type=card,position=free,representation=uncl)	NUM(type=card,position=free,representation=uncl)	NUM(type=card,position=free,representation=uncl)
NUM(type=card,position=free,representation=uncl,WF=abbr)	NUM(type=card,position=free,representation=uncl,WF=abbr)	NUM(type=card,position=free,representation=uncl,WF=abbr)
NUM(type=card,position=free,representation=uncl,WF=mis)	NUM(type=card,position=free,representation=uncl,WF=mis)	NUM(type=card,position=free,representation=uncl,WF=mis)
NUM(type=card,position=free,representation=uncl,WF=trunc)	NUM(type=card,position=free,representation=uncl,WF=trunc)	NUM(type=card,position=free,representation=uncl,WF=trunc)
NUM(type=card,position=postnom,representation=dig)	NUM(type=card,position=postnom,representation=dig)	NUM(type=card,position=postnom,representation=dig)
NUM(type=card,position=postnom,representation=dig,WF=abbr)	NUM(type=card,position=postnom,representation=dig,WF=abbr)	NUM(type=card,position=postnom,representation=dig,WF=abbr)
NUM(type=card,position=postnom,representation=dig,WF=mis)	NUM(type=card,position=postnom,representation=dig,WF=mis)	NUM(type=card,position=postnom,representation=dig,WF=mis)
NUM(type=card,position=postnom,representation=dig,WF=trunc)	NUM(type=card,position=postnom,representation=dig,WF=trunc)	NUM(type=card,position=postnom,representation=dig,WF=trunc)
NUM(type=card,position=postnom,representation=let)	NUM(type=card,position=postnom,representation=let)	NUM(type=card,position=postnom,representation=let)
NUM(type=card,position=postnom,representation=let,WF=abbr)	NUM(type=card,position=postnom,representation=let,WF=abbr)	NUM(type=card,position=postnom,representation=let,WF=abbr)
NUM(type=card,position=postnom,representation=let,WF=mis)	NUM(type=card,position=postnom,representation=let,WF=mis)	NUM(type=card,position=postnom,representation=let,WF=mis)
NUM(type=card,position=postnom,representation=let,WF=trunc)	NUM(type=card,position=postnom,representation=let,WF=trunc)	NUM(type=card,position=postnom,representation=let,WF=trunc)
NUM(type=card,position=postnom,representation=mix-dig)	NUM(type=card,position=postnom,representation=mix-dig)	NUM(type=card,position=postnom,representation=mix-dig)
NUM(type=card,position=postnom,representation=mix-dig,WF=abbr)	NUM(type=card,position=postnom,representation=mix-dig,WF=abbr)	NUM(type=card,position=postnom,representation=mix-dig,WF=abbr)
NUM(type=card,position=postnom,representation=mix-dig,WF=mis)	NUM(type=card,position=postnom,representation=mix-dig,WF=mis)	NUM(type=card,position=postnom,representation=mix-dig,WF=mis)
NUM(type=card,position=postnom,representation=mix-dig,WF=trunc)	NUM(type=card,position=postnom,representation=mix-dig,WF=trunc)	NUM(type=card,position=postnom,representation=mix-dig,WF=trunc)
NUM(type=card,position=postnom,representation=mix-rom)	NUM(type=card,position=postnom,representation=mix-rom)	NUM(type=card,position=postnom,representation=mix-rom)
NUM(type=card,position=postnom,representation=mix-rom,WF=abbr)	NUM(type=card,position=postnom,representation=mix-rom,WF=abbr)	NUM(type=card,position=postnom,representation=mix-rom,WF=abbr)
NUM(type=card,position=postnom,representation=mix-rom,WF=mis)	NUM(type=card,position=postnom,representation=mix-rom,WF=mis)	NUM(type=card,position=postnom,representation=mix-rom,WF=mis)
NUM(type=card,position=postnom,representation=mix-rom,WF=trunc)	NUM(type=card,position=postnom,representation=mix-rom,WF=trunc)	NUM(type=card,position=postnom,representation=mix-rom,WF=trunc)
NUM(type=card,position=postnom,representation=rom)	NUM(type=card,position=postnom,representation=rom)	NUM(type=card,position=postnom,representation=rom)
NUM(type=card,position=postnom,representation=rom,WF=abbr)	NUM(type=card,position=postnom,representation=rom,WF=abbr)	NUM(type=card,position=postnom,representation=rom,WF=abbr)
NUM(type=card,position=postnom,representation=rom,WF=mis)	NUM(type=card,position=postnom,representation=rom,WF=mis)	NUM(type=card,position=postnom,representation=rom,WF=mis)
NUM(type=card,position=postnom,representation=rom,WF=trunc)	NUM(type=card,position=postnom,representation=rom,WF=trunc)	NUM(type=card,position=postnom,representation=rom,WF=trunc)
NUM(type=card,position=postnom,representation=uncl)	NUM(type=card,position=postnom,representation=uncl)	NUM(type=card,position=postnom,representation=uncl)
NUM(type=card,position=postnom,representation=uncl,WF=abbr)	NUM(type=card,position=postnom,representation=uncl,WF=abbr)	NUM(type=card,position=postnom,representation=uncl,WF=abbr)
NUM(type=card,position=postnom,representation=uncl,WF=mis)	NUM(type=card,position=postnom,representation=uncl,WF=mis)	NUM(type=card,position=postnom,representation=uncl,WF=mis)
NUM(type=card,position=postnom,representation=uncl,WF=trunc)	NUM(type=card,position=postnom,representation=uncl,WF=trunc)	NUM(type=card,position=postnom,representation=uncl,WF=trunc)
NUM(type=card,position=prenom,representation=dig)	NUM(type=card,position=prenom,representation=dig)	NUM(type=card,position=prenom,representation=dig)
NUM(type=card,position=prenom,representation=dig,WF=abbr)	NUM(type=card,position=prenom,representation=dig,WF=abbr)	NUM(type=card,position=prenom,representation=dig,WF=abbr)
NUM(type=card,position=prenom,representation=dig,WF=mis)	NUM(type=card,position=prenom,representation=dig,WF=mis)	NUM(type=card,position=prenom,representation=dig,WF=mis)
NUM(type=card,position=prenom,representation=dig,WF=trunc)	NUM(type=card,position=prenom,representation=dig,WF=trunc)	NUM(type=card,position=prenom,representation=dig,WF=trunc)
NUM(type=card,position=prenom,representation=let)	NUM(type=card,position=prenom,representation=let)	NUM(type=card,position=prenom,representation=let)
NUM(type=card,position=prenom,representation=let,WF=abbr)	NUM(type=card,position=prenom,representation=let,WF=abbr)	NUM(type=card,position=prenom,representation=let,WF=abbr)
NUM(type=card,position=prenom,representation=let,WF=mis)	NUM(type=card,position=prenom,representation=let,WF=mis)	NUM(type=card,position=prenom,representation=let,WF=mis)
NUM(type=card,position=prenom,representation=let,WF=trunc)	NUM(type=card,position=prenom,representation=let,WF=trunc)	NUM(type=card,position=prenom,representation=let,WF=trunc)
NUM(type=card,position=prenom,representation=mix-dig)	NUM(type=card,position=prenom,representation=mix-dig)	NUM(type=card,position=prenom,representation=mix-dig)
NUM(type=card,position=prenom,representation=mix-dig,WF=abbr)	NUM(type=card,position=prenom,representation=mix-dig,WF=abbr)	NUM(type=card,position=prenom,representation=mix-dig,WF=abbr)
NUM(type=card,position=prenom,representation=mix-dig,WF=mis)	NUM(type=card,position=prenom,representation=mix-dig,WF=mis)	NUM(type=card,position=prenom,representation=mix-dig,WF=mis)
NUM(type=card,position=prenom,representation=mix-dig,WF=trunc)	NUM(type=card,position=prenom,representation=mix-dig,WF=trunc)	NUM(type=card,position=prenom,representation=mix-dig,WF=trunc)
NUM(type=card,position=prenom,representation=mix-rom)	NUM(type=card,position=prenom,representation=mix-rom)	NUM(type=card,position=prenom,representation=mix-rom)
NUM(type=card,position=prenom,representation=mix-rom,WF=abbr)	NUM(type=card,position=prenom,representation=mix-rom,WF=abbr)	NUM(type=card,position=prenom,representation=mix-rom,WF=abbr)
NUM(type=card,position=prenom,representation=mix-rom,WF=mis)	NUM(type=card,position=prenom,representation=mix-rom,WF=mis)	NUM(type=card,position=prenom,representation=mix-rom,WF=mis)
NUM(type=card,position=prenom,representation=mix-rom,WF=trunc)	NUM(type=card,position=prenom,representation=mix-rom,WF=trunc)	NUM(type=card,position=prenom,representation=mix-rom,WF=trunc)
NUM(type=card,position=prenom,representation=rom)	NUM(type=card,position=prenom,representation=rom)	NUM(type=card,position=prenom,representation=rom)
NUM(type=card,position=prenom,representation=rom,WF=abbr)	NUM(type=card,position=prenom,representation=rom,WF=abbr)	NUM(type=card,position=prenom,representation=rom,WF=abbr)
NUM(type=card,position=prenom,representation=rom,WF=mis)	NUM(type=card,position=prenom,representation=rom,WF=mis)	NUM(type=card,position=prenom,representation=rom,WF=mis)
NUM(type=card,position=prenom,representation=rom,WF=trunc)	NUM(type=card,position=prenom,representation=rom,WF=trunc)	NUM(type=card,position=prenom,representation=rom,WF=trunc)
NUM(type=card,position=prenom,representation=uncl)	NUM(type=card,position=prenom,representation=uncl)	NUM(type=card,position=prenom,representation=uncl)
NUM(type=card,position=prenom,representation=uncl,WF=abbr)	NUM(type=card,position=prenom,representation=uncl,WF=abbr)	NUM(type=card,position=prenom,representation=uncl,WF=abbr)
NUM(type=card,position=prenom,representation=uncl,WF=mis)	NUM(type=card,position=prenom,representation=uncl,WF=mis)	NUM(type=card,position=prenom,representation=uncl,WF=mis)
NUM(type=card,position=prenom,representation=uncl,WF=trunc)	NUM(type=card,position=prenom,representation=uncl,WF=trunc)	NUM(type=card,position=prenom,representation=uncl,WF=trunc)
NUM(type=card,position=uncl,representation=dig)	NUM(type=card,position=uncl,representation=dig)	NUM(type=card,position=uncl,representation=dig)
NUM(type=card,position=uncl,representation=dig,WF=abbr)	NUM(type=card,position=uncl,representation=dig,WF=abbr)	NUM(type=card,position=uncl,representation=dig,WF=abbr)
NUM(type=card,position=uncl,representation=dig,WF=mis)	NUM(type=card,position=uncl,representation=dig,WF=mis)	NUM(type=card,position=uncl,representation=dig,WF=mis)
NUM(type=card,position=uncl,representation=dig,WF=trunc)	NUM(type=card,position=uncl,representation=dig,WF=trunc)	NUM(type=card,position=uncl,representation=dig,WF=trunc)
NUM(type=card,position=uncl,representation=let)	NUM(type=card,position=uncl,representation=let)	NUM(type=card,position=uncl,representation=let)
NUM(type=card,position=uncl,representation=let,WF=abbr)	NUM(type=card,position=uncl,representation=let,WF=abbr)	NUM(type=card,position=uncl,representation=let,WF=abbr)
NUM(type=card,position=uncl,representation=let,WF=mis)	NUM(type=card,position=uncl,representation=let,WF=mis)	NUM(type=card,position=uncl,representation=let,WF=mis)
NUM(type=card,position=uncl,representation=let,WF=trunc)	NUM(type=card,position=uncl,representation=let,WF=trunc)	NUM(type=card,position=uncl,representation=let,WF=trunc)
NUM(type=card,position=uncl,representation=mix-dig)	NUM(type=card,position=uncl,representation=mix-dig)	NUM(type=card,position=uncl,representation=mix-dig)
NUM(type=card,position=uncl,representation=mix-dig,WF=abbr)	NUM(type=card,position=uncl,representation=mix-dig,WF=abbr)	NUM(type=card,position=uncl,representation=mix-dig,WF=abbr)
NUM(type=card,position=uncl,representation=mix-dig,WF=mis)	NUM(type=card,position=uncl,representation=mix-dig,WF=mis)	NUM(type=card,position=uncl,representation=mix-dig,WF=mis)
NUM(type=card,position=uncl,representation=mix-dig,WF=trunc)	NUM(type=card,position=uncl,representation=mix-dig,WF=trunc)	NUM(type=card,position=uncl,representation=mix-dig,WF=trunc)
NUM(type=card,position=uncl,representation=mix-rom)	NUM(type=card,position=uncl,representation=mix-rom)	NUM(type=card,position=uncl,representation=mix-rom)
NUM(type=card,position=uncl,representation=mix-rom,WF=abbr)	NUM(type=card,position=uncl,representation=mix-rom,WF=abbr)	NUM(type=card,position=uncl,representation=mix-rom,WF=abbr)
NUM(type=card,position=uncl,representation=mix-rom,WF=mis)	NUM(type=card,position=uncl,representation=mix-rom,WF=mis)	NUM(type=card,position=uncl,representation=mix-rom,WF=mis)
NUM(type=card,position=uncl,representation=mix-rom,WF=trunc)	NUM(type=card,position=uncl,representation=mix-rom,WF=trunc)	NUM(type=card,position=uncl,representation=mix-rom,WF=trunc)
NUM(type=card,position=uncl,representation=rom)	NUM(type=card,position=uncl,representation=rom)	NUM(type=card,position=uncl,representation=rom)
NUM(type=card,position=uncl,representation=rom,WF=abbr)	NUM(type=card,position=uncl,representation=rom,WF=abbr)	NUM(type=card,position=uncl,representation=rom,WF=abbr)
NUM(type=card,position=uncl,representation=rom,WF=mis)	NUM(type=card,position=uncl,representation=rom,WF=mis)	NUM(type=card,position=uncl,representation=rom,WF=mis)
NUM(type=card,position=uncl,representation=rom,WF=trunc)	NUM(type=card,position=uncl,representation=rom,WF=trunc)	NUM(type=card,position=uncl,representation=rom,WF=trunc)
NUM(type=card,position=uncl,representation=uncl)	NUM(type=card,position=uncl,representation=uncl)	NUM(type=card,position=uncl,representation=uncl)
NUM(type=card,position=uncl,representation=uncl,WF=abbr)	NUM(type=card,position=uncl,representation=uncl,WF=abbr)	NUM(type=card,position=uncl,representation=uncl,WF=abbr)
NUM(type=card,position=uncl,representation=uncl,WF=mis)	NUM(type=card,position=uncl,representation=uncl,WF=mis)	NUM(type=card,position=uncl,representation=uncl,WF=mis)
NUM(type=card,position=uncl,representation=uncl,WF=trunc)	NUM(type=card,position=uncl,representation=uncl,WF=trunc)	NUM(type=card,position=uncl,representation=uncl,WF=trunc)
NUM(type=ord,position=free,representation=dig)	NUM(type=ord,position=free,representation=dig)	NUM(type=ord,position=free,representation=dig)
NUM(type=ord,position=free,representation=dig,WF=abbr)	NUM(type=ord,position=free,representation=dig,WF=abbr)	NUM(type=ord,position=free,representation=dig,WF=abbr)
NUM(type=ord,position=free,representation=dig,WF=mis)	NUM(type=ord,position=free,representation=dig,WF=mis)	NUM(type=ord,position=free,representation=dig,WF=mis)
NUM(type=ord,position=free,representation=dig,WF=trunc)	NUM(type=ord,position=free,representation=dig,WF=trunc)	NUM(type=ord,position=free,representation=dig,WF=trunc)
NUM(type=ord,position=free,representation=let)	NUM(type=ord,position=free,representation=let)	NUM(type=ord,position=free,representation=let)
NUM(type=ord,position=free,representation=let,WF=abbr)	NUM(type=ord,position=free,representation=let,WF=abbr)	NUM(type=ord,position=free,representation=let,WF=abbr)
NUM(type=ord,position=free,representation=let,WF=mis)	NUM(type=ord,position=free,representation=let,WF=mis)	NUM(type=ord,position=free,representation=let,WF=mis)
NUM(type=ord,position=free,representation=let,WF=trunc)	NUM(type=ord,position=free,representation=let,WF=trunc)	NUM(type=ord,position=free,representation=let,WF=trunc)
NUM(type=ord,position=free,representation=mix-dig)	NUM(type=ord,position=free,representation=mix-dig)	NUM(type=ord,position=free,representation=mix-dig)
NUM(type=ord,position=free,representation=mix-dig,WF=abbr)	NUM(type=ord,position=free,representation=mix-dig,WF=abbr)	NUM(type=ord,position=free,representation=mix-dig,WF=abbr)
NUM(type=ord,position=free,representation=mix-dig,WF=mis)	NUM(type=ord,position=free,representation=mix-dig,WF=mis)	NUM(type=ord,position=free,representation=mix-dig,WF=mis)
NUM(type=ord,position=free,representation=mix-dig,WF=trunc)	NUM(type=ord,position=free,representation=mix-dig,WF=trunc)	NUM(type=ord,position=free,representation=mix-dig,WF=trunc)
NUM(type=ord,position=free,representation=mix-rom)	NUM(type=ord,position=free,representation=mix-rom)	NUM(type=ord,position=free,representation=mix-rom)
NUM(type=ord,position=free,representation=mix-rom,WF=abbr)	NUM(type=ord,position=free,representation=mix-rom,WF=abbr)	NUM(type=ord,position=free,representation=mix-rom,WF=abbr)
NUM(type=ord,position=free,representation=mix-rom,WF=mis)	NUM(type=ord,position=free,representation=mix-rom,WF=mis)	NUM(type=ord,position=free,representation=mix-rom,WF=mis)
NUM(type=ord,position=free,representation=mix-rom,WF=trunc)	NUM(type=ord,position=free,representation=mix-rom,WF=trunc)	NUM(type=ord,position=free,representation=mix-rom,WF=trunc)
NUM(type=ord,position=free,representation=rom)	NUM(type=ord,position=free,representation=rom)	NUM(type=ord,position=free,representation=rom)
NUM(type=ord,position=free,representation=rom,WF=abbr)	NUM(type=ord,position=free,representation=rom,WF=abbr)	NUM(type=ord,position=free,representation=rom,WF=abbr)
NUM(type=ord,position=free,representation=rom,WF=mis)	NUM(type=ord,position=free,representation=rom,WF=mis)	NUM(type=ord,position=free,representation=rom,WF=mis)
NUM(type=ord,position=free,representation=rom,WF=trunc)	NUM(type=ord,position=free,representation=rom,WF=trunc)	NUM(type=ord,position=free,representation=rom,WF=trunc)
NUM(type=ord,position=free,representation=uncl)	NUM(type=ord,position=free,representation=uncl)	NUM(type=ord,position=free,representation=uncl)
NUM(type=ord,position=free,representation=uncl,WF=abbr)	NUM(type=ord,position=free,representation=uncl,WF=abbr)	NUM(type=ord,position=free,representation=uncl,WF=abbr)
NUM(type=ord,position=free,representation=uncl,WF=mis)	NUM(type=ord,position=free,representation=uncl,WF=mis)	NUM(type=ord,position=free,representation=uncl,WF=mis)
NUM(type=ord,position=free,representation=uncl,WF=trunc)	NUM(type=ord,position=free,representation=uncl,WF=trunc)	NUM(type=ord,position=free,representation=uncl,WF=trunc)
NUM(type=ord,position=postnom,representation=dig)	NUM(type=ord,position=postnom,representation=dig)	NUM(type=ord,position=postnom,representation=dig)
NUM(type=ord,position=postnom,representation=dig,WF=abbr)	NUM(type=ord,position=postnom,representation=dig,WF=abbr)	NUM(type=ord,position=postnom,representation=dig,WF=abbr)
NUM(type=ord,position=postnom,representation=dig,WF=mis)	NUM(type=ord,position=postnom,representation=dig,WF=mis)	NUM(type=ord,position=postnom,representation=dig,WF=mis)
NUM(type=ord,position=postnom,representation=dig,WF=trunc)	NUM(type=ord,position=postnom,representation=dig,WF=trunc)	NUM(type=ord,position=postnom,representation=dig,WF=trunc)
NUM(type=ord,position=postnom,representation=let)	NUM(type=ord,position=postnom,representation=let)	NUM(type=ord,position=postnom,representation=let)
NUM(type=ord,position=postnom,representation=let,WF=abbr)	NUM(type=ord,position=postnom,representation=let,WF=abbr)	NUM(type=ord,position=postnom,representation=let,WF=abbr)
NUM(type=ord,position=postnom,representation=let,WF=mis)	NUM(type=ord,position=postnom,representation=let,WF=mis)	NUM(type=ord,position=postnom,representation=let,WF=mis)
NUM(type=ord,position=postnom,representation=let,WF=trunc)	NUM(type=ord,position=postnom,representation=let,WF=trunc)	NUM(type=ord,position=postnom,representation=let,WF=trunc)
NUM(type=ord,position=postnom,representation=mix-dig)	NUM(type=ord,position=postnom,representation=mix-dig)	NUM(type=ord,position=postnom,representation=mix-dig)
NUM(type=ord,position=postnom,representation=mix-dig,WF=abbr)	NUM(type=ord,position=postnom,representation=mix-dig,WF=abbr)	NUM(type=ord,position=postnom,representation=mix-dig,WF=abbr)
NUM(type=ord,position=postnom,representation=mix-dig,WF=mis)	NUM(type=ord,position=postnom,representation=mix-dig,WF=mis)	NUM(type=ord,position=postnom,representation=mix-dig,WF=mis)
NUM(type=ord,position=postnom,representation=mix-dig,WF=trunc)	NUM(type=ord,position=postnom,representation=mix-dig,WF=trunc)	NUM(type=ord,position=postnom,representation=mix-dig,WF=trunc)
NUM(type=ord,position=postnom,representation=mix-rom)	NUM(type=ord,position=postnom,representation=mix-rom)	NUM(type=ord,position=postnom,representation=mix-rom)
NUM(type=ord,position=postnom,representation=mix-rom,WF=abbr)	NUM(type=ord,position=postnom,representation=mix-rom,WF=abbr)	NUM(type=ord,position=postnom,representation=mix-rom,WF=abbr)
NUM(type=ord,position=postnom,representation=mix-rom,WF=mis)	NUM(type=ord,position=postnom,representation=mix-rom,WF=mis)	NUM(type=ord,position=postnom,representation=mix-rom,WF=mis)
NUM(type=ord,position=postnom,representation=mix-rom,WF=trunc)	NUM(type=ord,position=postnom,representation=mix-rom,WF=trunc)	NUM(type=ord,position=postnom,representation=mix-rom,WF=trunc)
NUM(type=ord,position=postnom,representation=rom)	NUM(type=ord,position=postnom,representation=rom)	NUM(type=ord,position=postnom,representation=rom)
NUM(type=ord,position=postnom,representation=rom,WF=abbr)	NUM(type=ord,position=postnom,representation=rom,WF=abbr)	NUM(type=ord,position=postnom,representation=rom,WF=abbr)
NUM(type=ord,position=postnom,representation=rom,WF=mis)	NUM(type=ord,position=postnom,representation=rom,WF=mis)	NUM(type=ord,position=postnom,representation=rom,WF=mis)
NUM(type=ord,position=postnom,representation=rom,WF=trunc)	NUM(type=ord,position=postnom,representation=rom,WF=trunc)	NUM(type=ord,position=postnom,representation=rom,WF=trunc)
NUM(type=ord,position=postnom,representation=uncl)	NUM(type=ord,position=postnom,representation=uncl)	NUM(type=ord,position=postnom,representation=uncl)
NUM(type=ord,position=postnom,representation=uncl,WF=abbr)	NUM(type=ord,position=postnom,representation=uncl,WF=abbr)	NUM(type=ord,position=postnom,representation=uncl,WF=abbr)
NUM(type=ord,position=postnom,representation=uncl,WF=mis)	NUM(type=ord,position=postnom,representation=uncl,WF=mis)	NUM(type=ord,position=postnom,representation=uncl,WF=mis)
NUM(type=ord,position=postnom,representation=uncl,WF=trunc)	NUM(type=ord,position=postnom,representation=uncl,WF=trunc)	NUM(type=ord,position=postnom,representation=uncl,WF=trunc)
NUM(type=ord,position=prenom,representation=dig)	NUM(type=ord,position=prenom,representation=dig)	NUM(type=ord,position=prenom,representation=dig)
NUM(type=ord,position=prenom,representation=dig,WF=abbr)	NUM(type=ord,position=prenom,representation=dig,WF=abbr)	NUM(type=ord,position=prenom,representation=dig,WF=abbr)
NUM(type=ord,position=prenom,representation=dig,WF=mis)	NUM(type=ord,position=prenom,representation=dig,WF=mis)	NUM(type=ord,position=prenom,representation=dig,WF=mis)
NUM(type=ord,position=prenom,representation=dig,WF=trunc)	NUM(type=ord,position=prenom,representation=dig,WF=trunc)	NUM(type=ord,position=prenom,representation=dig,WF=trunc)
NUM(type=ord,position=prenom,representation=let)	NUM(type=ord,position=prenom,representation=let)	NUM(type=ord,position=prenom,representation=let)
NUM(type=ord,position=prenom,representation=let,WF=abbr)	NUM(type=ord,position=prenom,representation=let,WF=abbr)	NUM(type=ord,position=prenom,representation=let,WF=abbr)
NUM(type=ord,position=prenom,representation=let,WF=mis)	NUM(type=ord,position=prenom,representation=let,WF=mis)	NUM(type=ord,position=prenom,representation=let,WF=mis)
NUM(type=ord,position=prenom,representation=let,WF=trunc)	NUM(type=ord,position=prenom,representation=let,WF=trunc)	NUM(type=ord,position=prenom,representation=let,WF=trunc)
NUM(type=ord,position=prenom,representation=mix-dig)	NUM(type=ord,position=prenom,representation=mix-dig)	NUM(type=ord,position=prenom,representation=mix-dig)
NUM(type=ord,position=prenom,representation=mix-dig,WF=abbr)	NUM(type=ord,position=prenom,representation=mix-dig,WF=abbr)	NUM(type=ord,position=prenom,representation=mix-dig,WF=abbr)
NUM(type=ord,position=prenom,representation=mix-dig,WF=mis)	NUM(type=ord,position=prenom,representation=mix-dig,WF=mis)	NUM(type=ord,position=prenom,representation=mix-dig,WF=mis)
NUM(type=ord,position=prenom,representation=mix-dig,WF=trunc)	NUM(type=ord,position=prenom,representation=mix-dig,WF=trunc)	NUM(type=ord,position=prenom,representation=mix-dig,WF=trunc)
NUM(type=ord,position=prenom,representation=mix-rom)	NUM(type=ord,position=prenom,representation=mix-rom)	NUM(type=ord,position=prenom,representation=mix-rom)
NUM(type=ord,position=prenom,representation=mix-rom,WF=abbr)	NUM(type=ord,position=prenom,representation=mix-rom,WF=abbr)	NUM(type=ord,position=prenom,representation=mix-rom,WF=abbr)
NUM(type=ord,position=prenom,representation=mix-rom,WF=mis)	NUM(type=ord,position=prenom,representation=mix-rom,WF=mis)	NUM(type=ord,position=prenom,representation=mix-rom,WF=mis)
NUM(type=ord,position=prenom,representation=mix-rom,WF=trunc)	NUM(type=ord,position=prenom,representation=mix-rom,WF=trunc)	NUM(type=ord,position=prenom,representation=mix-rom,WF=trunc)
NUM(type=ord,position=prenom,representation=rom)	NUM(type=ord,position=prenom,representation=rom)	NUM(type=ord,position=prenom,representation=rom)
NUM(type=ord,position=prenom,representation=rom,WF=abbr)	NUM(type=ord,position=prenom,representation=rom,WF=abbr)	NUM(type=ord,position=prenom,representation=rom,WF=abbr)
NUM(type=ord,position=prenom,representation=rom,WF=mis)	NUM(type=ord,position=prenom,representation=rom,WF=mis)	NUM(type=ord,position=prenom,representation=rom,WF=mis)
NUM(type=ord,position=prenom,representation=rom,WF=trunc)	NUM(type=ord,position=prenom,representation=rom,WF=trunc)	NUM(type=ord,position=prenom,representation=rom,WF=trunc)
NUM(type=ord,position=prenom,representation=uncl)	NUM(type=ord,position=prenom,representation=uncl)	NUM(type=ord,position=prenom,representation=uncl)
NUM(type=ord,position=prenom,representation=uncl,WF=abbr)	NUM(type=ord,position=prenom,representation=uncl,WF=abbr)	NUM(type=ord,position=prenom,representation=uncl,WF=abbr)
NUM(type=ord,position=prenom,representation=uncl,WF=mis)	NUM(type=ord,position=prenom,representation=uncl,WF=mis)	NUM(type=ord,position=prenom,representation=uncl,WF=mis)
NUM(type=ord,position=prenom,representation=uncl,WF=trunc)	NUM(type=ord,position=prenom,representation=uncl,WF=trunc)	NUM(type=ord,position=prenom,representation=uncl,WF=trunc)
NUM(type=ord,position=uncl,representation=dig)	NUM(type=ord,position=uncl,representation=dig)	NUM(type=ord,position=uncl,representation=dig)
NUM(type=ord,position=uncl,representation=dig,WF=abbr)	NUM(type=ord,position=uncl,representation=dig,WF=abbr)	NUM(type=ord,position=uncl,representation=dig,WF=abbr)
NUM(type=ord,position=uncl,representation=dig,WF=mis)	NUM(type=ord,position=uncl,representation=dig,WF=mis)	NUM(type=ord,position=uncl,representation=dig,WF=mis)
NUM(type=ord,position=uncl,representation=dig,WF=trunc)	NUM(type=ord,position=uncl,representation=dig,WF=trunc)	NUM(type=ord,position=uncl,representation=dig,WF=trunc)
NUM(type=ord,position=uncl,representation=let)	NUM(type=ord,position=uncl,representation=let)	NUM(type=ord,position=uncl,representation=let)
NUM(type=ord,position=uncl,representation=let,WF=abbr)	NUM(type=ord,position=uncl,representation=let,WF=abbr)	NUM(type=ord,position=uncl,representation=let,WF=abbr)
NUM(type=ord,position=uncl,representation=let,WF=mis)	NUM(type=ord,position=uncl,representation=let,WF=mis)	NUM(type=ord,position=uncl,representation=let,WF=mis)
NUM(type=ord,position=uncl,representation=let,WF=trunc)	NUM(type=ord,position=uncl,representation=let,WF=trunc)	NUM(type=ord,position=uncl,representation=let,WF=trunc)
NUM(type=ord,position=uncl,representation=mix-dig)	NUM(type=ord,position=uncl,representation=mix-dig)	NUM(type=ord,position=uncl,representation=mix-dig)
NUM(type=ord,position=uncl,representation=mix-dig,WF=abbr)	NUM(type=ord,position=uncl,representation=mix-dig,WF=abbr)	NUM(type=ord,position=uncl,representation=mix-dig,WF=abbr)
NUM(type=ord,position=uncl,representation=mix-dig,WF=mis)	NUM(type=ord,position=uncl,representation=mix-dig,WF=mis)	NUM(type=ord,position=uncl,representation=mix-dig,WF=mis)
NUM(type=ord,position=uncl,representation=mix-dig,WF=trunc)	NUM(type=ord,position=uncl,representation=mix-dig,WF=trunc)	NUM(type=ord,position=uncl,representation=mix-dig,WF=trunc)
NUM(type=ord,position=uncl,representation=mix-rom)	NUM(type=ord,position=uncl,representation=mix-rom)	NUM(type=ord,position=uncl,representation=mix-rom)
NUM(type=ord,position=uncl,representation=mix-rom,WF=abbr)	NUM(type=ord,position=uncl,representation=mix-rom,WF=abbr)	NUM(type=ord,position=uncl,representation=mix-rom,WF=abbr)
NUM(type=ord,position=uncl,representation=mix-rom,WF=mis)	NUM(type=ord,position=uncl,representation=mix-rom,WF=mis)	NUM(type=ord,position=uncl,representation=mix-rom,WF=mis)
NUM(type=ord,position=uncl,representation=mix-rom,WF=trunc)	NUM(type=ord,position=uncl,representation=mix-rom,WF=trunc)	NUM(type=ord,position=uncl,representation=mix-rom,WF=trunc)
NUM(type=ord,position=uncl,representation=rom)	NUM(type=ord,position=uncl,representation=rom)	NUM(type=ord,position=uncl,representation=rom)
NUM(type=ord,position=uncl,representation=rom,WF=abbr)	NUM(type=ord,position=uncl,representation=rom,WF=abbr)	NUM(type=ord,position=uncl,representation=rom,WF=abbr)
NUM(type=ord,position=uncl,representation=rom,WF=mis)	NUM(type=ord,position=uncl,representation=rom,WF=mis)	NUM(type=ord,position=uncl,representation=rom,WF=mis)
NUM(type=ord,position=uncl,representation=rom,WF=trunc)	NUM(type=ord,position=uncl,representation=rom,WF=trunc)	NUM(type=ord,position=uncl,representation=rom,WF=trunc)
NUM(type=ord,position=uncl,representation=uncl)	NUM(type=ord,position=uncl,representation=uncl)	NUM(type=ord,position=uncl,representation=uncl)
NUM(type=ord,position=uncl,representation=uncl,WF=abbr)	NUM(type=ord,position=uncl,representation=uncl,WF=abbr)	NUM(type=ord,position=uncl,representation=uncl,WF=abbr)
NUM(type=ord,position=uncl,representation=uncl,WF=mis)	NUM(type=ord,position=uncl,representation=uncl,WF=mis)	NUM(type=ord,position=uncl,representation=uncl,WF=mis)
NUM(type=ord,position=uncl,representation=uncl,WF=trunc)	NUM(type=ord,position=uncl,representation=uncl,WF=trunc)	NUM(type=ord,position=uncl,representation=uncl,WF=trunc)
NUM(type=uncl,position=free,representation=dig)	NUM(type=uncl,position=free,representation=dig)	NUM(type=uncl,position=free,representation=dig)
NUM(type=uncl,position=free,representation=dig,WF=abbr)	NUM(type=uncl,position=free,representation=dig,WF=abbr)	NUM(type=uncl,position=free,representation=dig,WF=abbr)
NUM(type=uncl,position=free,representation=dig,WF=mis)	NUM(type=uncl,position=free,representation=dig,WF=mis)	NUM(type=uncl,position=free,representation=dig,WF=mis)
NUM(type=uncl,position=free,representation=dig,WF=trunc)	NUM(type=uncl,position=free,representation=dig,WF=trunc)	NUM(type=uncl,position=free,representation=dig,WF=trunc)
NUM(type=uncl,position=free,representation=let)	NUM(type=uncl,position=free,representation=let)	NUM(type=uncl,position=free,representation=let)
NUM(type=uncl,position=free,representation=let,WF=abbr)	NUM(type=uncl,position=free,representation=let,WF=abbr)	NUM(type=uncl,position=free,representation=let,WF=abbr)
NUM(type=uncl,position=free,representation=let,WF=mis)	NUM(type=uncl,position=free,representation=let,WF=mis)	NUM(type=uncl,position=free,representation=let,WF=mis)
NUM(type=uncl,position=free,representation=let,WF=trunc)	NUM(type=uncl,position=free,representation=let,WF=trunc)	NUM(type=uncl,position=free,representation=let,WF=trunc)
NUM(type=uncl,position=free,representation=mix-dig)	NUM(type=uncl,position=free,representation=mix-dig)	NUM(type=uncl,position=free,representation=mix-dig)
NUM(type=uncl,position=free,representation=mix-dig,WF=abbr)	NUM(type=uncl,position=free,representation=mix-dig,WF=abbr)	NUM(type=uncl,position=free,representation=mix-dig,WF=abbr)
NUM(type=uncl,position=free,representation=mix-dig,WF=mis)	NUM(type=uncl,position=free,representation=mix-dig,WF=mis)	NUM(type=uncl,position=free,representation=mix-dig,WF=mis)
NUM(type=uncl,position=free,representation=mix-dig,WF=trunc)	NUM(type=uncl,position=free,representation=mix-dig,WF=trunc)	NUM(type=uncl,position=free,representation=mix-dig,WF=trunc)
NUM(type=uncl,position=free,representation=mix-rom)	NUM(type=uncl,position=free,representation=mix-rom)	NUM(type=uncl,position=free,representation=mix-rom)
NUM(type=uncl,position=free,representation=mix-rom,WF=abbr)	NUM(type=uncl,position=free,representation=mix-rom,WF=abbr)	NUM(type=uncl,position=free,representation=mix-rom,WF=abbr)
NUM(type=uncl,position=free,representation=mix-rom,WF=mis)	NUM(type=uncl,position=free,representation=mix-rom,WF=mis)	NUM(type=uncl,position=free,representation=mix-rom,WF=mis)
NUM(type=uncl,position=free,representation=mix-rom,WF=trunc)	NUM(type=uncl,position=free,representation=mix-rom,WF=trunc)	NUM(type=uncl,position=free,representation=mix-rom,WF=trunc)
NUM(type=uncl,position=free,representation=rom)	NUM(type=uncl,position=free,representation=rom)	NUM(type=uncl,position=free,representation=rom)
NUM(type=uncl,position=free,representation=rom,WF=abbr)	NUM(type=uncl,position=free,representation=rom,WF=abbr)	NUM(type=uncl,position=free,representation=rom,WF=abbr)
NUM(type=uncl,position=free,representation=rom,WF=mis)	NUM(type=uncl,position=free,representation=rom,WF=mis)	NUM(type=uncl,position=free,representation=rom,WF=mis)
NUM(type=uncl,position=free,representation=rom,WF=trunc)	NUM(type=uncl,position=free,representation=rom,WF=trunc)	NUM(type=uncl,position=free,representation=rom,WF=trunc)
NUM(type=uncl,position=free,representation=uncl)	NUM(type=uncl,position=free,representation=uncl)	NUM(type=uncl,position=free,representation=uncl)
NUM(type=uncl,position=free,representation=uncl,WF=abbr)	NUM(type=uncl,position=free,representation=uncl,WF=abbr)	NUM(type=uncl,position=free,representation=uncl,WF=abbr)
NUM(type=uncl,position=free,representation=uncl,WF=mis)	NUM(type=uncl,position=free,representation=uncl,WF=mis)	NUM(type=uncl,position=free,representation=uncl,WF=mis)
NUM(type=uncl,position=free,representation=uncl,WF=trunc)	NUM(type=uncl,position=free,representation=uncl,WF=trunc)	NUM(type=uncl,position=free,representation=uncl,WF=trunc)
NUM(type=uncl,position=postnom,representation=dig)	NUM(type=uncl,position=postnom,representation=dig)	NUM(type=uncl,position=postnom,representation=dig)
NUM(type=uncl,position=postnom,representation=dig,WF=abbr)	NUM(type=uncl,position=postnom,representation=dig,WF=abbr)	NUM(type=uncl,position=postnom,representation=dig,WF=abbr)
NUM(type=uncl,position=postnom,representation=dig,WF=mis)	NUM(type=uncl,position=postnom,representation=dig,WF=mis)	NUM(type=uncl,position=postnom,representation=dig,WF=mis)
NUM(type=uncl,position=postnom,representation=dig,WF=trunc)	NUM(type=uncl,position=postnom,representation=dig,WF=trunc)	NUM(type=uncl,position=postnom,representation=dig,WF=trunc)
NUM(type=uncl,position=postnom,representation=let)	NUM(type=uncl,position=postnom,representation=let)	NUM(type=uncl,position=postnom,representation=let)
NUM(type=uncl,position=postnom,representation=let,WF=abbr)	NUM(type=uncl,position=postnom,representation=let,WF=abbr)	NUM(type=uncl,position=postnom,representation=let,WF=abbr)
NUM(type=uncl,position=postnom,representation=let,WF=mis)	NUM(type=uncl,position=postnom,representation=let,WF=mis)	NUM(type=uncl,position=postnom,representation=let,WF=mis)
NUM(type=uncl,position=postnom,representation=let,WF=trunc)	NUM(type=uncl,position=postnom,representation=let,WF=trunc)	NUM(type=uncl,position=postnom,representation=let,WF=trunc)
NUM(type=uncl,position=postnom,representation=mix-dig)	NUM(type=uncl,position=postnom,representation=mix-dig)	NUM(type=uncl,position=postnom,representation=mix-dig)
NUM(type=uncl,position=postnom,representation=mix-dig,WF=abbr)	NUM(type=uncl,position=postnom,representation=mix-dig,WF=abbr)	NUM(type=uncl,position=postnom,representation=mix-dig,WF=abbr)
NUM(type=uncl,position=postnom,representation=mix-dig,WF=mis)	NUM(type=uncl,position=postnom,representation=mix-dig,WF=mis)	NUM(type=uncl,position=postnom,representation=mix-dig,WF=mis)
NUM(type=uncl,position=postnom,representation=mix-dig,WF=trunc)	NUM(type=uncl,position=postnom,representation=mix-dig,WF=trunc)	NUM(type=uncl,position=postnom,representation=mix-dig,WF=trunc)
NUM(type=uncl,position=postnom,representation=mix-rom)	NUM(type=uncl,position=postnom,representation=mix-rom)	NUM(type=uncl,position=postnom,representation=mix-rom)
NUM(type=uncl,position=postnom,representation=mix-rom,WF=abbr)	NUM(type=uncl,position=postnom,representation=mix-rom,WF=abbr)	NUM(type=uncl,position=postnom,representation=mix-rom,WF=abbr)
NUM(type=uncl,position=postnom,representation=mix-rom,WF=mis)	NUM(type=uncl,position=postnom,representation=mix-rom,WF=mis)	NUM(type=uncl,position=postnom,representation=mix-rom,WF=mis)
NUM(type=uncl,position=postnom,representation=mix-rom,WF=trunc)	NUM(type=uncl,position=postnom,representation=mix-rom,WF=trunc)	NUM(type=uncl,position=postnom,representation=mix-rom,WF=trunc)
NUM(type=uncl,position=postnom,representation=rom)	NUM(type=uncl,position=postnom,representation=rom)	NUM(type=uncl,position=postnom,representation=rom)
NUM(type=uncl,position=postnom,representation=rom,WF=abbr)	NUM(type=uncl,position=postnom,representation=rom,WF=abbr)	NUM(type=uncl,position=postnom,representation=rom,WF=abbr)
NUM(type=uncl,position=postnom,representation=rom,WF=mis)	NUM(type=uncl,position=postnom,representation=rom,WF=mis)	NUM(type=uncl,position=postnom,representation=rom,WF=mis)
NUM(type=uncl,position=postnom,representation=rom,WF=trunc)	NUM(type=uncl,position=postnom,representation=rom,WF=trunc)	NUM(type=uncl,position=postnom,representation=rom,WF=trunc)
NUM(type=uncl,position=postnom,representation=uncl)	NUM(type=uncl,position=postnom,representation=uncl)	NUM(type=uncl,position=postnom,representation=uncl)
NUM(type=uncl,position=postnom,representation=uncl,WF=abbr)	NUM(type=uncl,position=postnom,representation=uncl,WF=abbr)	NUM(type=uncl,position=postnom,representation=uncl,WF=abbr)
NUM(type=uncl,position=postnom,representation=uncl,WF=mis)	NUM(type=uncl,position=postnom,representation=uncl,WF=mis)	NUM(type=uncl,position=postnom,representation=uncl,WF=mis)
NUM(type=uncl,position=postnom,representation=uncl,WF=trunc)	NUM(type=uncl,position=postnom,representation=uncl,WF=trunc)	NUM(type=uncl,position=postnom,representation=uncl,WF=trunc)
NUM(type=uncl,position=prenom,representation=dig)	NUM(type=uncl,position=prenom,representation=dig)	NUM(type=uncl,position=prenom,representation=dig)
NUM(type=uncl,position=prenom,representation=dig,WF=abbr)	NUM(type=uncl,position=prenom,representation=dig,WF=abbr)	NUM(type=uncl,position=prenom,representation=dig,WF=abbr)
NUM(type=uncl,position=prenom,representation=dig,WF=mis)	NUM(type=uncl,position=prenom,representation=dig,WF=mis)	NUM(type=uncl,position=prenom,representation=dig,WF=mis)
NUM(type=uncl,position=prenom,representation=dig,WF=trunc)	NUM(type=uncl,position=prenom,representation=dig,WF=trunc)	NUM(type=uncl,position=prenom,representation=dig,WF=trunc)
NUM(type=uncl,position=prenom,representation=let)	NUM(type=uncl,position=prenom,representation=let)	NUM(type=uncl,position=prenom,representation=let)
NUM(type=uncl,position=prenom,representation=let,WF=abbr)	NUM(type=uncl,position=prenom,representation=let,WF=abbr)	NUM(type=uncl,position=prenom,representation=let,WF=abbr)
NUM(type=uncl,position=prenom,representation=let,WF=mis)	NUM(type=uncl,position=prenom,representation=let,WF=mis)	NUM(type=uncl,position=prenom,representation=let,WF=mis)
NUM(type=uncl,position=prenom,representation=let,WF=trunc)	NUM(type=uncl,position=prenom,representation=let,WF=trunc)	NUM(type=uncl,position=prenom,representation=let,WF=trunc)
NUM(type=uncl,position=prenom,representation=mix-dig)	NUM(type=uncl,position=prenom,representation=mix-dig)	NUM(type=uncl,position=prenom,representation=mix-dig)
NUM(type=uncl,position=prenom,representation=mix-dig,WF=abbr)	NUM(type=uncl,position=prenom,representation=mix-dig,WF=abbr)	NUM(type=uncl,position=prenom,representation=mix-dig,WF=abbr)
NUM(type=uncl,position=prenom,representation=mix-dig,WF=mis)	NUM(type=uncl,position=prenom,representation=mix-dig,WF=mis)	NUM(type=uncl,position=prenom,representation=mix-dig,WF=mis)
NUM(type=uncl,position=prenom,representation=mix-dig,WF=trunc)	NUM(type=uncl,position=prenom,representation=mix-dig,WF=trunc)	NUM(type=uncl,position=prenom,representation=mix-dig,WF=trunc)
NUM(type=uncl,position=prenom,representation=mix-rom)	NUM(type=uncl,position=prenom,representation=mix-rom)	NUM(type=uncl,position=prenom,representation=mix-rom)
NUM(type=uncl,position=prenom,representation=mix-rom,WF=abbr)	NUM(type=uncl,position=prenom,representation=mix-rom,WF=abbr)	NUM(type=uncl,position=prenom,representation=mix-rom,WF=abbr)
NUM(type=uncl,position=prenom,representation=mix-rom,WF=mis)	NUM(type=uncl,position=prenom,representation=mix-rom,WF=mis)	NUM(type=uncl,position=prenom,representation=mix-rom,WF=mis)
NUM(type=uncl,position=prenom,representation=mix-rom,WF=trunc)	NUM(type=uncl,position=prenom,representation=mix-rom,WF=trunc)	NUM(type=uncl,position=prenom,representation=mix-rom,WF=trunc)
NUM(type=uncl,position=prenom,representation=rom)	NUM(type=uncl,position=prenom,representation=rom)	NUM(type=uncl,position=prenom,representation=rom)
NUM(type=uncl,position=prenom,representation=rom,WF=abbr)	NUM(type=uncl,position=prenom,representation=rom,WF=abbr)	NUM(type=uncl,position=prenom,representation=rom,WF=abbr)
NUM(type=uncl,position=prenom,representation=rom,WF=mis)	NUM(type=uncl,position=prenom,representation=rom,WF=mis)	NUM(type=uncl,position=prenom,representation=rom,WF=mis)
NUM(type=uncl,position=prenom,representation=rom,WF=trunc)	NUM(type=uncl,position=prenom,representation=rom,WF=trunc)	NUM(type=uncl,position=prenom,representation=rom,WF=trunc)
NUM(type=uncl,position=prenom,representation=uncl)	NUM(type=uncl,position=prenom,representation=uncl)	NUM(type=uncl,position=prenom,representation=uncl)
NUM(type=uncl,position=prenom,representation=uncl,WF=abbr)	NUM(type=uncl,position=prenom,representation=uncl,WF=abbr)	NUM(type=uncl,position=prenom,representation=uncl,WF=abbr)
NUM(type=uncl,position=prenom,representation=uncl,WF=mis)	NUM(type=uncl,position=prenom,representation=uncl,WF=mis)	NUM(type=uncl,position=prenom,representation=uncl,WF=mis)
NUM(type=uncl,position=prenom,representation=uncl,WF=trunc)	NUM(type=uncl,position=prenom,representation=uncl,WF=trunc)	NUM(type=uncl,position=prenom,representation=uncl,WF=trunc)
NUM(type=uncl,position=uncl,representation=dig)	NUM(type=uncl,position=uncl,representation=dig)	NUM(type=uncl,position=uncl,representation=dig)
NUM(type=uncl,position=uncl,representation=dig,WF=abbr)	NUM(type=uncl,position=uncl,representation=dig,WF=abbr)	NUM(type=uncl,position=uncl,representation=dig,WF=abbr)
NUM(type=uncl,position=uncl,representation=dig,WF=mis)	NUM(type=uncl,position=uncl,representation=dig,WF=mis)	NUM(type=uncl,position=uncl,representation=dig,WF=mis)
NUM(type=uncl,position=uncl,representation=dig,WF=trunc)	NUM(type=uncl,position=uncl,representation=dig,WF=trunc)	NUM(type=uncl,position=uncl,representation=dig,WF=trunc)
NUM(type=uncl,position=uncl,representation=let)	NUM(type=uncl,position=uncl,representation=let)	NUM(type=uncl,position=uncl,representation=let)
NUM(type=uncl,position=uncl,representation=let,WF=abbr)	NUM(type=uncl,position=uncl,representation=let,WF=abbr)	NUM(type=uncl,position=uncl,representation=let,WF=abbr)
NUM(type=uncl,position=uncl,representation=let,WF=mis)	NUM(type=uncl,position=uncl,representation=let,WF=mis)	NUM(type=uncl,position=uncl,representation=let,WF=mis)
NUM(type=uncl,position=uncl,representation=let,WF=trunc)	NUM(type=uncl,position=uncl,representation=let,WF=trunc)	NUM(type=uncl,position=uncl,representation=let,WF=trunc)
NUM(type=uncl,position=uncl,representation=mix-dig)	NUM(type=uncl,position=uncl,representation=mix-dig)	NUM(type=uncl,position=uncl,representation=mix-dig)
NUM(type=uncl,position=uncl,representation=mix-dig,WF=abbr)	NUM(type=uncl,position=uncl,representation=mix-dig,WF=abbr)	NUM(type=uncl,position=uncl,representation=mix-dig,WF=abbr)
NUM(type=uncl,position=uncl,representation=mix-dig,WF=mis)	NUM(type=uncl,position=uncl,representation=mix-dig,WF=mis)	NUM(type=uncl,position=uncl,representation=mix-dig,WF=mis)
NUM(type=uncl,position=uncl,representation=mix-dig,WF=trunc)	NUM(type=uncl,position=uncl,representation=mix-dig,WF=trunc)	NUM(type=uncl,position=uncl,representation=mix-dig,WF=trunc)
NUM(type=uncl,position=uncl,representation=mix-rom)	NUM(type=uncl,position=uncl,representation=mix-rom)	NUM(type=uncl,position=uncl,representation=mix-rom)
NUM(type=uncl,position=uncl,representation=mix-rom,WF=abbr)	NUM(type=uncl,position=uncl,representation=mix-rom,WF=abbr)	NUM(type=uncl,position=uncl,representation=mix-rom,WF=abbr)
NUM(type=uncl,position=uncl,representation=mix-rom,WF=mis)	NUM(type=uncl,position=uncl,representation=mix-rom,WF=mis)	NUM(type=uncl,position=uncl,representation=mix-rom,WF=mis)
NUM(type=uncl,position=uncl,representation=mix-rom,WF=trunc)	NUM(type=uncl,position=uncl,representation=mix-rom,WF=trunc)	NUM(type=uncl,position=uncl,representation=mix-rom,WF=trunc)
NUM(type=uncl,position=uncl,representation=rom)	NUM(type=uncl,position=uncl,representation=rom)	NUM(type=uncl,position=uncl,representation=rom)
NUM(type=uncl,position=uncl,representation=rom,WF=abbr)	NUM(type=uncl,position=uncl,representation=rom,WF=abbr)	NUM(type=uncl,position=uncl,representation=rom,WF=abbr)
NUM(type=uncl,position=uncl,representation=rom,WF=mis)	NUM(type=uncl,position=uncl,representation=rom,WF=mis)	NUM(type=uncl,position=uncl,representation=rom,WF=mis)
NUM(type=uncl,position=uncl,representation=rom,WF=trunc)	NUM(type=uncl,position=uncl,representation=rom,WF=trunc)	NUM(type=uncl,position=uncl,representation=rom,WF=trunc)
NUM(type=uncl,position=uncl,representation=uncl)	NUM(type=uncl,position=uncl,representation=uncl)	NUM(type=uncl,position=uncl,representation=uncl)
NUM(type=uncl,position=uncl,representation=uncl,WF=abbr)	NUM(type=uncl,position=uncl,representation=uncl,WF=abbr)	NUM(type=uncl,position=uncl,representation=uncl,WF=abbr)
NUM(type=uncl,position=uncl,representation=uncl,WF=mis)	NUM(type=uncl,position=uncl,representation=uncl,WF=mis)	NUM(type=uncl,position=uncl,representation=uncl,WF=mis)
NUM(type=uncl,position=uncl,representation=uncl,WF=trunc)	NUM(type=uncl,position=uncl,representation=uncl,WF=trunc)	NUM(type=uncl,position=uncl,representation=uncl,WF=trunc)
PD(type=d-p,position=free)	PD(type=d-p,position=free)	PD(type=d-p,position=free)
PD(type=d-p,position=free,WF=abbr)	PD(type=d-p,position=free,WF=abbr)	PD(type=d-p,position=free,WF=abbr)
PD(type=d-p,position=free,WF=mis)	PD(type=d-p,position=free,WF=mis)	PD(type=d-p,position=free,WF=mis)
PD(type=d-p,position=free,WF=trunc)	PD(type=d-p,position=free,WF=trunc)	PD(type=d-p,position=free,WF=trunc)
PD(type=d-p,position=postnom)	PD(type=d-p,position=postnom)	PD(type=d-p,position=postnom)
PD(type=d-p,position=postnom,WF=abbr)	PD(type=d-p,position=postnom,WF=abbr)	PD(type=d-p,position=postnom,WF=abbr)
PD(type=d-p,position=postnom,WF=mis)	PD(type=d-p,position=postnom,WF=mis)	PD(type=d-p,position=postnom,WF=mis)
PD(type=d-p,position=postnom,WF=trunc)	PD(type=d-p,position=postnom,WF=trunc)	PD(type=d-p,position=postnom,WF=trunc)
PD(type=d-p,subtype=art,position=prenom)	PD(type=d-p,subtype=art,position=prenom)	PD(type=d-p,subtype=art,position=prenom)
PD(type=d-p,subtype=art,position=prenom,WF=abbr)	PD(type=d-p,subtype=art,position=prenom,WF=abbr)	PD(type=d-p,subtype=art,position=prenom,WF=abbr)
PD(type=d-p,subtype=art,position=prenom,WF=mis)	PD(type=d-p,subtype=art,position=prenom,WF=mis)	PD(type=d-p,subtype=art,position=prenom,WF=mis)
PD(type=d-p,subtype=art,position=prenom,WF=trunc)	PD(type=d-p,subtype=art,position=prenom,WF=trunc)	PD(type=d-p,subtype=art,position=prenom,WF=trunc)
PD(type=d-p,subtype=oth,position=prenom)	PD(type=d-p,subtype=oth,position=prenom)	PD(type=d-p,subtype=oth,position=prenom)
PD(type=d-p,subtype=oth,position=prenom,WF=abbr)	PD(type=d-p,subtype=oth,position=prenom,WF=abbr)	PD(type=d-p,subtype=oth,position=prenom,WF=abbr)
PD(type=d-p,subtype=oth,position=prenom,WF=mis)	PD(type=d-p,subtype=oth,position=prenom,WF=mis)	PD(type=d-p,subtype=oth,position=prenom,WF=mis)
PD(type=d-p,subtype=oth,position=prenom,WF=trunc)	PD(type=d-p,subtype=oth,position=prenom,WF=trunc)	PD(type=d-p,subtype=oth,position=prenom,WF=trunc)
PD(type=d-p,subtype=oth,position=uncl)	PD(type=d-p,subtype=oth,position=uncl)	PD(type=d-p,subtype=oth,position=uncl)
PD(type=d-p,subtype=oth,position=uncl,WF=abbr)	PD(type=d-p,subtype=oth,position=uncl,WF=abbr)	PD(type=d-p,subtype=oth,position=uncl,WF=abbr)
PD(type=d-p,subtype=oth,position=uncl,WF=mis)	PD(type=d-p,subtype=oth,position=uncl,WF=mis)	PD(type=d-p,subtype=oth,position=uncl,WF=mis)
PD(type=d-p,subtype=oth,position=uncl,WF=trunc)	PD(type=d-p,subtype=oth,position=uncl,WF=trunc)	PD(type=d-p,subtype=oth,position=uncl,WF=trunc)
PD(type=d-p,subtype=uncl,position=prenom)	PD(type=d-p,subtype=uncl,position=prenom)	PD(type=d-p,subtype=uncl,position=prenom)
PD(type=d-p,subtype=uncl,position=prenom,WF=abbr)	PD(type=d-p,subtype=uncl,position=prenom,WF=abbr)	PD(type=d-p,subtype=uncl,position=prenom,WF=abbr)
PD(type=d-p,subtype=uncl,position=prenom,WF=mis)	PD(type=d-p,subtype=uncl,position=prenom,WF=mis)	PD(type=d-p,subtype=uncl,position=prenom,WF=mis)
PD(type=d-p,subtype=uncl,position=prenom,WF=trunc)	PD(type=d-p,subtype=uncl,position=prenom,WF=trunc)	PD(type=d-p,subtype=uncl,position=prenom,WF=trunc)
PD(type=d-p,subtype=uncl,position=uncl)	PD(type=d-p,subtype=uncl,position=uncl)	PD(type=d-p,subtype=uncl,position=uncl)
PD(type=d-p,subtype=uncl,position=uncl,WF=abbr)	PD(type=d-p,subtype=uncl,position=uncl,WF=abbr)	PD(type=d-p,subtype=uncl,position=uncl,WF=abbr)
PD(type=d-p,subtype=uncl,position=uncl,WF=mis)	PD(type=d-p,subtype=uncl,position=uncl,WF=mis)	PD(type=d-p,subtype=uncl,position=uncl,WF=mis)
PD(type=d-p,subtype=uncl,position=uncl,WF=trunc)	PD(type=d-p,subtype=uncl,position=uncl,WF=trunc)	PD(type=d-p,subtype=uncl,position=uncl,WF=trunc)
PD(type=excl,position=free)	PD(type=excl,position=free)	PD(type=excl,position=free)
PD(type=excl,position=free,WF=abbr)	PD(type=excl,position=free,WF=abbr)	PD(type=excl,position=free,WF=abbr)
PD(type=excl,position=free,WF=mis)	PD(type=excl,position=free,WF=mis)	PD(type=excl,position=free,WF=mis)
PD(type=excl,position=free,WF=trunc)	PD(type=excl,position=free,WF=trunc)	PD(type=excl,position=free,WF=trunc)
PD(type=excl,position=postnom)	PD(type=excl,position=postnom)	PD(type=excl,position=postnom)
PD(type=excl,position=postnom,WF=abbr)	PD(type=excl,position=postnom,WF=abbr)	PD(type=excl,position=postnom,WF=abbr)
PD(type=excl,position=postnom,WF=mis)	PD(type=excl,position=postnom,WF=mis)	PD(type=excl,position=postnom,WF=mis)
PD(type=excl,position=postnom,WF=trunc)	PD(type=excl,position=postnom,WF=trunc)	PD(type=excl,position=postnom,WF=trunc)
PD(type=excl,position=prenom)	PD(type=excl,position=prenom)	PD(type=excl,position=prenom)
PD(type=excl,position=prenom,WF=abbr)	PD(type=excl,position=prenom,WF=abbr)	PD(type=excl,position=prenom,WF=abbr)
PD(type=excl,position=prenom,WF=mis)	PD(type=excl,position=prenom,WF=mis)	PD(type=excl,position=prenom,WF=mis)
PD(type=excl,position=prenom,WF=trunc)	PD(type=excl,position=prenom,WF=trunc)	PD(type=excl,position=prenom,WF=trunc)
PD(type=excl,position=uncl)	PD(type=excl,position=uncl)	PD(type=excl,position=uncl)
PD(type=excl,position=uncl,WF=abbr)	PD(type=excl,position=uncl,WF=abbr)	PD(type=excl,position=uncl,WF=abbr)
PD(type=excl,position=uncl,WF=mis)	PD(type=excl,position=uncl,WF=mis)	PD(type=excl,position=uncl,WF=mis)
PD(type=excl,position=uncl,WF=trunc)	PD(type=excl,position=uncl,WF=trunc)	PD(type=excl,position=uncl,WF=trunc)
PD(type=indef,position=free)	PD(type=indef,position=free)	PD(type=indef,position=free)
PD(type=indef,position=free,WF=abbr)	PD(type=indef,position=free,WF=abbr)	PD(type=indef,position=free,WF=abbr)
PD(type=indef,position=free,WF=mis)	PD(type=indef,position=free,WF=mis)	PD(type=indef,position=free,WF=mis)
PD(type=indef,position=free,WF=trunc)	PD(type=indef,position=free,WF=trunc)	PD(type=indef,position=free,WF=trunc)
PD(type=indef,position=postnom)	PD(type=indef,position=postnom)	PD(type=indef,position=postnom)
PD(type=indef,position=postnom,WF=abbr)	PD(type=indef,position=postnom,WF=abbr)	PD(type=indef,position=postnom,WF=abbr)
PD(type=indef,position=postnom,WF=mis)	PD(type=indef,position=postnom,WF=mis)	PD(type=indef,position=postnom,WF=mis)
PD(type=indef,position=postnom,WF=trunc)	PD(type=indef,position=postnom,WF=trunc)	PD(type=indef,position=postnom,WF=trunc)
PD(type=indef,subtype=art,position=prenom)	PD(type=indef,subtype=art,position=prenom)	PD(type=indef,subtype=art,position=prenom)
PD(type=indef,subtype=art,position=prenom,WF=abbr)	PD(type=indef,subtype=art,position=prenom,WF=abbr)	PD(type=indef,subtype=art,position=prenom,WF=abbr)
PD(type=indef,subtype=art,position=prenom,WF=mis)	PD(type=indef,subtype=art,position=prenom,WF=mis)	PD(type=indef,subtype=art,position=prenom,WF=mis)
PD(type=indef,subtype=art,position=prenom,WF=trunc)	PD(type=indef,subtype=art,position=prenom,WF=trunc)	PD(type=indef,subtype=art,position=prenom,WF=trunc)
PD(type=indef,subtype=oth,position=prenom)	PD(type=indef,subtype=oth,position=prenom)	PD(type=indef,subtype=oth,position=prenom)
PD(type=indef,subtype=oth,position=prenom,WF=abbr)	PD(type=indef,subtype=oth,position=prenom,WF=abbr)	PD(type=indef,subtype=oth,position=prenom,WF=abbr)
PD(type=indef,subtype=oth,position=prenom,WF=mis)	PD(type=indef,subtype=oth,position=prenom,WF=mis)	PD(type=indef,subtype=oth,position=prenom,WF=mis)
PD(type=indef,subtype=oth,position=prenom,WF=trunc)	PD(type=indef,subtype=oth,position=prenom,WF=trunc)	PD(type=indef,subtype=oth,position=prenom,WF=trunc)
PD(type=indef,subtype=oth,position=uncl)	PD(type=indef,subtype=oth,position=uncl)	PD(type=indef,subtype=oth,position=uncl)
PD(type=indef,subtype=oth,position=uncl,WF=abbr)	PD(type=indef,subtype=oth,position=uncl,WF=abbr)	PD(type=indef,subtype=oth,position=uncl,WF=abbr)
PD(type=indef,subtype=oth,position=uncl,WF=mis)	PD(type=indef,subtype=oth,position=uncl,WF=mis)	PD(type=indef,subtype=oth,position=uncl,WF=mis)
PD(type=indef,subtype=oth,position=uncl,WF=trunc)	PD(type=indef,subtype=oth,position=uncl,WF=trunc)	PD(type=indef,subtype=oth,position=uncl,WF=trunc)
PD(type=indef,subtype=uncl,position=prenom)	PD(type=indef,subtype=uncl,position=prenom)	PD(type=indef,subtype=uncl,position=prenom)
PD(type=indef,subtype=uncl,position=prenom,WF=abbr)	PD(type=indef,subtype=uncl,position=prenom,WF=abbr)	PD(type=indef,subtype=uncl,position=prenom,WF=abbr)
PD(type=indef,subtype=uncl,position=prenom,WF=mis)	PD(type=indef,subtype=uncl,position=prenom,WF=mis)	PD(type=indef,subtype=uncl,position=prenom,WF=mis)
PD(type=indef,subtype=uncl,position=prenom,WF=trunc)	PD(type=indef,subtype=uncl,position=prenom,WF=trunc)	PD(type=indef,subtype=uncl,position=prenom,WF=trunc)
PD(type=indef,subtype=uncl,position=uncl)	PD(type=indef,subtype=uncl,position=uncl)	PD(type=indef,subtype=uncl,position=uncl)
PD(type=indef,subtype=uncl,position=uncl,WF=abbr)	PD(type=indef,subtype=uncl,position=uncl,WF=abbr)	PD(type=indef,subtype=uncl,position=uncl,WF=abbr)
PD(type=indef,subtype=uncl,position=uncl,WF=mis)	PD(type=indef,subtype=uncl,position=uncl,WF=mis)	PD(type=indef,subtype=uncl,position=uncl,WF=mis)
PD(type=indef,subtype=uncl,position=uncl,WF=trunc)	PD(type=indef,subtype=uncl,position=uncl,WF=trunc)	PD(type=indef,subtype=uncl,position=uncl,WF=trunc)
PD(type=pers,position=free)	PD(type=pers,position=free)	PD(type=pers,position=free)
PD(type=pers,position=free,WF=abbr)	PD(type=pers,position=free,WF=abbr)	PD(type=pers,position=free,WF=abbr)
PD(type=pers,position=free,WF=mis)	PD(type=pers,position=free,WF=mis)	PD(type=pers,position=free,WF=mis)
PD(type=pers,position=free,WF=trunc)	PD(type=pers,position=free,WF=trunc)	PD(type=pers,position=free,WF=trunc)
PD(type=poss,position=free)	PD(type=poss,position=free)	PD(type=poss,position=free)
PD(type=poss,position=free,WF=abbr)	PD(type=poss,position=free,WF=abbr)	PD(type=poss,position=free,WF=abbr)
PD(type=poss,position=free,WF=mis)	PD(type=poss,position=free,WF=mis)	PD(type=poss,position=free,WF=mis)
PD(type=poss,position=free,WF=trunc)	PD(type=poss,position=free,WF=trunc)	PD(type=poss,position=free,WF=trunc)
PD(type=poss,position=postnom)	PD(type=poss,position=postnom)	PD(type=poss,position=postnom)
PD(type=poss,position=postnom,WF=abbr)	PD(type=poss,position=postnom,WF=abbr)	PD(type=poss,position=postnom,WF=abbr)
PD(type=poss,position=postnom,WF=mis)	PD(type=poss,position=postnom,WF=mis)	PD(type=poss,position=postnom,WF=mis)
PD(type=poss,position=postnom,WF=trunc)	PD(type=poss,position=postnom,WF=trunc)	PD(type=poss,position=postnom,WF=trunc)
PD(type=poss,position=prenom)	PD(type=poss,position=prenom)	PD(type=poss,position=prenom)
PD(type=poss,position=prenom,WF=abbr)	PD(type=poss,position=prenom,WF=abbr)	PD(type=poss,position=prenom,WF=abbr)
PD(type=poss,position=prenom,WF=mis)	PD(type=poss,position=prenom,WF=mis)	PD(type=poss,position=prenom,WF=mis)
PD(type=poss,position=prenom,WF=trunc)	PD(type=poss,position=prenom,WF=trunc)	PD(type=poss,position=prenom,WF=trunc)
PD(type=poss,position=uncl)	PD(type=poss,position=uncl)	PD(type=poss,position=uncl)
PD(type=poss,position=uncl,WF=abbr)	PD(type=poss,position=uncl,WF=abbr)	PD(type=poss,position=uncl,WF=abbr)
PD(type=poss,position=uncl,WF=mis)	PD(type=poss,position=uncl,WF=mis)	PD(type=poss,position=uncl,WF=mis)
PD(type=poss,position=uncl,WF=trunc)	PD(type=poss,position=uncl,WF=trunc)	PD(type=poss,position=uncl,WF=trunc)
PD(type=recip,position=free)	PD(type=recip,position=free)	PD(type=recip,position=free)
PD(type=recip,position=free,WF=abbr)	PD(type=recip,position=free,WF=abbr)	PD(type=recip,position=free,WF=abbr)
PD(type=recip,position=free,WF=mis)	PD(type=recip,position=free,WF=mis)	PD(type=recip,position=free,WF=mis)
PD(type=recip,position=free,WF=trunc)	PD(type=recip,position=free,WF=trunc)	PD(type=recip,position=free,WF=trunc)
PD(type=refl,position=free)	PD(type=refl,position=free)	PD(type=refl,position=free)
PD(type=refl,position=free,WF=abbr)	PD(type=refl,position=free,WF=abbr)	PD(type=refl,position=free,WF=abbr)
PD(type=refl,position=free,WF=mis)	PD(type=refl,position=free,WF=mis)	PD(type=refl,position=free,WF=mis)
PD(type=refl,position=free,WF=trunc)	PD(type=refl,position=free,WF=trunc)	PD(type=refl,position=free,WF=trunc)
PD(type=uncl,position=free)	PD(type=uncl,position=free)	PD(type=uncl,position=free)
PD(type=uncl,position=free,WF=abbr)	PD(type=uncl,position=free,WF=abbr)	PD(type=uncl,position=free,WF=abbr)
PD(type=uncl,position=free,WF=mis)	PD(type=uncl,position=free,WF=mis)	PD(type=uncl,position=free,WF=mis)
PD(type=uncl,position=free,WF=trunc)	PD(type=uncl,position=free,WF=trunc)	PD(type=uncl,position=free,WF=trunc)
PD(type=uncl,position=postnom)	PD(type=uncl,position=postnom)	PD(type=uncl,position=postnom)
PD(type=uncl,position=postnom,WF=abbr)	PD(type=uncl,position=postnom,WF=abbr)	PD(type=uncl,position=postnom,WF=abbr)
PD(type=uncl,position=postnom,WF=mis)	PD(type=uncl,position=postnom,WF=mis)	PD(type=uncl,position=postnom,WF=mis)
PD(type=uncl,position=postnom,WF=trunc)	PD(type=uncl,position=postnom,WF=trunc)	PD(type=uncl,position=postnom,WF=trunc)
PD(type=uncl,subtype=art,position=prenom)	PD(type=uncl,subtype=art,position=prenom)	PD(type=uncl,subtype=art,position=prenom)
PD(type=uncl,subtype=art,position=prenom,WF=abbr)	PD(type=uncl,subtype=art,position=prenom,WF=abbr)	PD(type=uncl,subtype=art,position=prenom,WF=abbr)
PD(type=uncl,subtype=art,position=prenom,WF=mis)	PD(type=uncl,subtype=art,position=prenom,WF=mis)	PD(type=uncl,subtype=art,position=prenom,WF=mis)
PD(type=uncl,subtype=art,position=prenom,WF=trunc)	PD(type=uncl,subtype=art,position=prenom,WF=trunc)	PD(type=uncl,subtype=art,position=prenom,WF=trunc)
PD(type=uncl,subtype=oth,position=prenom)	PD(type=uncl,subtype=oth,position=prenom)	PD(type=uncl,subtype=oth,position=prenom)
PD(type=uncl,subtype=oth,position=prenom,WF=abbr)	PD(type=uncl,subtype=oth,position=prenom,WF=abbr)	PD(type=uncl,subtype=oth,position=prenom,WF=abbr)
PD(type=uncl,subtype=oth,position=prenom,WF=mis)	PD(type=uncl,subtype=oth,position=prenom,WF=mis)	PD(type=uncl,subtype=oth,position=prenom,WF=mis)
PD(type=uncl,subtype=oth,position=prenom,WF=trunc)	PD(type=uncl,subtype=oth,position=prenom,WF=trunc)	PD(type=uncl,subtype=oth,position=prenom,WF=trunc)
PD(type=uncl,subtype=oth,position=uncl)	PD(type=uncl,subtype=oth,position=uncl)	PD(type=uncl,subtype=oth,position=uncl)
PD(type=uncl,subtype=oth,position=uncl,WF=abbr)	PD(type=uncl,subtype=oth,position=uncl,WF=abbr)	PD(type=uncl,subtype=oth,position=uncl,WF=abbr)
PD(type=uncl,subtype=oth,position=uncl,WF=mis)	PD(type=uncl,subtype=oth,position=uncl,WF=mis)	PD(type=uncl,subtype=oth,position=uncl,WF=mis)
PD(type=uncl,subtype=oth,position=uncl,WF=trunc)	PD(type=uncl,subtype=oth,position=uncl,WF=trunc)	PD(type=uncl,subtype=oth,position=uncl,WF=trunc)
PD(type=uncl,subtype=uncl,position=prenom)	PD(type=uncl,subtype=uncl,position=prenom)	PD(type=uncl,subtype=uncl,position=prenom)
PD(type=uncl,subtype=uncl,position=prenom,WF=abbr)	PD(type=uncl,subtype=uncl,position=prenom,WF=abbr)	PD(type=uncl,subtype=uncl,position=prenom,WF=abbr)
PD(type=uncl,subtype=uncl,position=prenom,WF=mis)	PD(type=uncl,subtype=uncl,position=prenom,WF=mis)	PD(type=uncl,subtype=uncl,position=prenom,WF=mis)
PD(type=uncl,subtype=uncl,position=prenom,WF=trunc)	PD(type=uncl,subtype=uncl,position=prenom,WF=trunc)	PD(type=uncl,subtype=uncl,position=prenom,WF=trunc)
PD(type=uncl,subtype=uncl,position=uncl)	PD(type=uncl,subtype=uncl,position=uncl)	PD(type=uncl,subtype=uncl,position=uncl)
PD(type=uncl,subtype=uncl,position=uncl,WF=abbr)	PD(type=uncl,subtype=uncl,position=uncl,WF=abbr)	PD(type=uncl,subtype=uncl,position=uncl,WF=abbr)
PD(type=uncl,subtype=uncl,position=uncl,WF=mis)	PD(type=uncl,subtype=uncl,position=uncl,WF=mis)	PD(type=uncl,subtype=uncl,position=uncl,WF=mis)
PD(type=uncl,subtype=uncl,position=uncl,WF=trunc)	PD(type=uncl,subtype=uncl,position=uncl,WF=trunc)	PD(type=uncl,subtype=uncl,position=uncl,WF=trunc)
PD(type=w-p,position=free)	PD(type=w-p,position=free)	PD(type=w-p,position=free)
PD(type=w-p,position=free,WF=abbr)	PD(type=w-p,position=free,WF=abbr)	PD(type=w-p,position=free,WF=abbr)
PD(type=w-p,position=free,WF=mis)	PD(type=w-p,position=free,WF=mis)	PD(type=w-p,position=free,WF=mis)
PD(type=w-p,position=free,WF=trunc)	PD(type=w-p,position=free,WF=trunc)	PD(type=w-p,position=free,WF=trunc)
PD(type=w-p,position=postnom)	PD(type=w-p,position=postnom)	PD(type=w-p,position=postnom)
PD(type=w-p,position=postnom,WF=abbr)	PD(type=w-p,position=postnom,WF=abbr)	PD(type=w-p,position=postnom,WF=abbr)
PD(type=w-p,position=postnom,WF=mis)	PD(type=w-p,position=postnom,WF=mis)	PD(type=w-p,position=postnom,WF=mis)
PD(type=w-p,position=postnom,WF=trunc)	PD(type=w-p,position=postnom,WF=trunc)	PD(type=w-p,position=postnom,WF=trunc)
PD(type=w-p,position=prenom)	PD(type=w-p,position=prenom)	PD(type=w-p,position=prenom)
PD(type=w-p,position=prenom,WF=abbr)	PD(type=w-p,position=prenom,WF=abbr)	PD(type=w-p,position=prenom,WF=abbr)
PD(type=w-p,position=prenom,WF=mis)	PD(type=w-p,position=prenom,WF=mis)	PD(type=w-p,position=prenom,WF=mis)
PD(type=w-p,position=prenom,WF=trunc)	PD(type=w-p,position=prenom,WF=trunc)	PD(type=w-p,position=prenom,WF=trunc)
PD(type=w-p,position=uncl)	PD(type=w-p,position=uncl)	PD(type=w-p,position=uncl)
PD(type=w-p,position=uncl,WF=abbr)	PD(type=w-p,position=uncl,WF=abbr)	PD(type=w-p,position=uncl,WF=abbr)
PD(type=w-p,position=uncl,WF=mis)	PD(type=w-p,position=uncl,WF=mis)	PD(type=w-p,position=uncl,WF=mis)
PD(type=w-p,position=uncl,WF=trunc)	PD(type=w-p,position=uncl,WF=trunc)	PD(type=w-p,position=uncl,WF=trunc)
RES(type=aff)	RES(type=aff)	RES(type=aff)
RES(type=aff,WF=abbr)	RES(type=aff,WF=abbr)	RES(type=aff,WF=abbr)
RES(type=aff,WF=mis)	RES(type=aff,WF=mis)	RES(type=aff,WF=mis)
RES(type=aff,WF=trunc)	RES(type=aff,WF=trunc)	RES(type=aff,WF=trunc)
RES(type=for)	RES(type=for)	RES(type=for)
RES(type=for,WF=abbr)	RES(type=for,WF=abbr)	RES(type=for,WF=abbr)
RES(type=for,WF=mis)	RES(type=for,WF=mis)	RES(type=for,WF=mis)
RES(type=for,WF=trunc)	RES(type=for,WF=trunc)	RES(type=for,WF=trunc)
RES(type=form)	RES(type=form)	RES(type=form)
RES(type=form,WF=abbr)	RES(type=form,WF=abbr)	RES(type=form,WF=abbr)
RES(type=form,WF=mis)	RES(type=form,WF=mis)	RES(type=form,WF=mis)
RES(type=form,WF=trunc)	RES(type=form,WF=trunc)	RES(type=form,WF=trunc)
RES(type=meta)	RES(type=meta)	RES(type=meta)
RES(type=meta,WF=abbr)	RES(type=meta,WF=abbr)	RES(type=meta,WF=abbr)
RES(type=meta,WF=mis)	RES(type=meta,WF=mis)	RES(type=meta,WF=mis)
RES(type=meta,WF=trunc)	RES(type=meta,WF=trunc)	RES(type=meta,WF=trunc)
		RES(type=oth)
RES(type=oth)	RES(type=oth)	RES(type=oth)
RES(type=oth,WF=abbr)	RES(type=oth,WF=abbr)	RES(type=oth,WF=abbr)
RES(type=oth,WF=mis)	RES(type=oth,WF=mis)	RES(type=oth,WF=mis)
RES(type=oth,WF=trunc)	RES(type=oth,WF=trunc)	RES(type=oth,WF=trunc)
RES(type=symb)	RES(type=symb)	RES(type=symb)
RES(type=symb,WF=abbr)	RES(type=symb,WF=abbr)	RES(type=symb,WF=abbr)
RES(type=symb,WF=mis)	RES(type=symb,WF=mis)	RES(type=symb,WF=mis)
RES(type=symb,WF=trunc)	RES(type=symb,WF=trunc)	RES(type=symb,WF=trunc)
RES(type=uncl)	RES(type=uncl)	RES(type=uncl)
RES(type=uncl,WF=abbr)	RES(type=uncl,WF=abbr)	RES(type=uncl,WF=abbr)
RES(type=uncl,WF=mis)	RES(type=uncl,WF=mis)	RES(type=uncl,WF=mis)
RES(type=uncl,WF=trunc)	RES(type=uncl,WF=trunc)	RES(type=uncl,WF=trunc)
VRB(finiteness=fin,tense=past)	VRB(finiteness=fin,tense=past)	VRB(finiteness=fin,tense=past)
VRB(finiteness=fin,tense=past,WF=abbr)	VRB(finiteness=fin,tense=past,WF=abbr)	VRB(finiteness=fin,tense=past,WF=abbr)
VRB(finiteness=fin,tense=past,WF=mis)	VRB(finiteness=fin,tense=past,WF=mis)	VRB(finiteness=fin,tense=past,WF=mis)
VRB(finiteness=fin,tense=past,WF=trunc)	VRB(finiteness=fin,tense=past,WF=trunc)	VRB(finiteness=fin,tense=past,WF=trunc)
VRB(finiteness=fin,tense=pres)	VRB(finiteness=fin,tense=pres)	VRB(finiteness=fin,tense=pres)
VRB(finiteness=fin,tense=pres,WF=abbr)	VRB(finiteness=fin,tense=pres,WF=abbr)	VRB(finiteness=fin,tense=pres,WF=abbr)
VRB(finiteness=fin,tense=pres,WF=mis)	VRB(finiteness=fin,tense=pres,WF=mis)	VRB(finiteness=fin,tense=pres,WF=mis)
VRB(finiteness=fin,tense=pres,WF=trunc)	VRB(finiteness=fin,tense=pres,WF=trunc)	VRB(finiteness=fin,tense=pres,WF=trunc)
VRB(finiteness=fin,tense=uncl)	VRB(finiteness=fin,tense=uncl)	VRB(finiteness=fin,tense=uncl)
VRB(finiteness=fin,tense=uncl,WF=abbr)	VRB(finiteness=fin,tense=uncl,WF=abbr)	VRB(finiteness=fin,tense=uncl,WF=abbr)
VRB(finiteness=fin,tense=uncl,WF=mis)	VRB(finiteness=fin,tense=uncl,WF=mis)	VRB(finiteness=fin,tense=uncl,WF=mis)
VRB(finiteness=fin,tense=uncl,WF=trunc)	VRB(finiteness=fin,tense=uncl,WF=trunc)	VRB(finiteness=fin,tense=uncl,WF=trunc)
VRB(finiteness=inf)	VRB(finiteness=inf)	VRB(finiteness=inf)
VRB(finiteness=inf,WF=abbr)	VRB(finiteness=inf,WF=abbr)	VRB(finiteness=inf,WF=abbr)
VRB(finiteness=inf,WF=mis)	VRB(finiteness=inf,WF=mis)	VRB(finiteness=inf,WF=mis)
VRB(finiteness=inf,WF=trunc)	VRB(finiteness=inf,WF=trunc)	VRB(finiteness=inf,WF=trunc)
VRB(finiteness=pastpart)	VRB(finiteness=pastpart)	VRB(finiteness=pastpart)
VRB(finiteness=pastpart,WF=abbr)	VRB(finiteness=pastpart,WF=abbr)	VRB(finiteness=pastpart,WF=abbr)
VRB(finiteness=pastpart,WF=mis)	VRB(finiteness=pastpart,WF=mis)	VRB(finiteness=pastpart,WF=mis)
VRB(finiteness=pastpart,WF=trunc)	VRB(finiteness=pastpart,WF=trunc)	VRB(finiteness=pastpart,WF=trunc)
VRB(finiteness=prespart)	VRB(finiteness=prespart)	VRB(finiteness=prespart)
VRB(finiteness=prespart,WF=abbr)	VRB(finiteness=prespart,WF=abbr)	VRB(finiteness=prespart,WF=abbr)
VRB(finiteness=prespart,WF=mis)	VRB(finiteness=prespart,WF=mis)	VRB(finiteness=prespart,WF=mis)
VRB(finiteness=prespart,WF=trunc)	VRB(finiteness=prespart,WF=trunc)	VRB(finiteness=prespart,WF=trunc)
VRB(finiteness=uncl,tense=uncl)	VRB(finiteness=uncl,tense=uncl)	VRB(finiteness=uncl,tense=uncl)
VRB(finiteness=uncl,tense=uncl,WF=abbr)	VRB(finiteness=uncl,tense=uncl,WF=abbr)	VRB(finiteness=uncl,tense=uncl,WF=abbr)
VRB(finiteness=uncl,tense=uncl,WF=mis)	VRB(finiteness=uncl,tense=uncl,WF=mis)	VRB(finiteness=uncl,tense=uncl,WF=mis)
VRB(finiteness=uncl,tense=uncl,WF=trunc)	VRB(finiteness=uncl,tense=uncl,WF=trunc)	VRB(finiteness=uncl,tense=uncl,WF=trunc)
