Aaf halen	af|halen	halen	halen
aan belangd	aan|belangen	belangd	belangen
aan belangs	aan|belangen	belangs	belangen
aan belangt	aan|belangen	belangt	belangen
aan Belangt	aan|belangen	Belangt	belangen
aan betreft	aan|betreffen	betreft	betreffen
aan beveele	aan|bevelen	beveele	bevelen
aan beveelen	aan|bevelen	beveelen	bevelen
aan beveelende	aan|bevelen	beveelende	bevelen
aan bevele	aan|bevelen	bevele	bevelen
aan bevelen	aan|bevelen	bevelen	bevelen
aan bevolen	aan|bevelen	bevolen	bevelen
aan bevoole	aan|bevelen	bevoole	bevelen
aan bevoolen	aan|bevelen	bevoolen	bevelen
aan bood	aan|bieden	bood	bieden
aan doen	aan|doen	doen	doen
aan doet	aan|doen	doet	doen
aan gaad	aan|gaan	gaad	gaan
aan gaaet	aan|gaan	gaaet	gaan
aan gaan	aan|gaan	gaan	gaan
aan gaat	aan|gaan	gaat	gaan
Aan gaat	aan|gaan	gaat	gaan
Aan Gaat	aan|gaan	Gaat	gaan
aan gaet	aan|gaan	gaet	gaan
aan gat	aan|gaan	gat	gaan
Aan Gat	aan|gaan	Gat	gaan
aan gekomen	aan|komen	gekomen	komen
aan geland	aan|landen	geland	landen
aan genomen	aan|nemen	genomen	nemen
aange noomen	aan|nemen	noomen	nemen
aan geraaden	aan|raden	geraaden	raden
aan gerade	aan|raden	gerade	raden
aan gericht	aan|richten	gericht	richten
aan gesteld	aan|stellen	gesteld	stellen
aan getast	aan|tasten	getast	tasten
aan getroffen	aan|treffen	getroffen	treffen
aan gezien	aan|gezien	gezien	gezien
aan graat	aan|gaan	graat	gaan
aan hangen	aan|hangen	hangen	hangen
aan hoore	aan|horen	hoore	horen
Aan houd	aan|houden	houd	houden
aan houde	aan|houden	houde	houden
aan houden	aan|houden	houden	houden
Aan houden	aan|houden	houden	houden
aan houwde	aan|houden	houwde	houden
aan houwen	aan|houden	houwen	houden
aan kante	aan|kanten	kante	kanten
Aan kommen	aan|komen	kommen	komen
aan koom	aan|komen	koom	komen
aan koomen	aan|komen	koomen	komen
aan loop	aan|lopen	loop	lopen
aan matigen	aan|matigen	matigen	matigen
aan merken	aan|merken	merken	merken
aan moedigen	aan|moedigen	moedigen	moedigen
aan neeme	aan|nemen	neeme	nemen
aan neemen	aan|nemen	neemen	nemen
aan Neemen	aan|nemen	Neemen	nemen
aan nemen	aan|nemen	nemen	nemen
aan raden	aan|raden	raden	raden
aan Rake	aan|raken	Rake	raken
aan Roopt	aan|roepen	Roopt	roepen
aan schouwen	aan|schouwen	schouwen	schouwen
aan schryf	aan|schrijven	schryf	schrijven
aan sien	aan|zien	sien	zien
aan staat	aan|staan	staat	staan
aan treeffen	aan|treffen	treeffen	treffen
Aan trefen	aan|treffen	trefen	treffen
aan treffe	aan|treffen	treffe	treffen
Aan treffe	aan|treffen	treffe	treffen
aan treffein	aan|treffen	treffein	treffen
aan treffen	aan|treffen	treffen	treffen
Aan treffen	aan|treffen	treffen	treffen
Aan Treffen	aan|treffen	Treffen	treffen
aan Treffen gesont	aan|treffen	Treffen	treffen
aan vangen	aan|vangen	vangen	vangen
aan wende	aan|wenden	wende	wenden
aan zien	aan|zien	zien	zien
achter blive	achter|blijven	blive	blijven
achter gelatten	achter|laten	gelatten	laten
achter houden	achter|houden	houden	houden
achterom komen	achter|omkomen	komen	omkomen
achteruijt setten	achter|uitzetten	setten	uitzetten
achter volgen	achter|volgen	volgen	volgen
aduijs d	ad|viseren	d	viseren
aduijs t	ad|viseren	t	viseren
ad venteeren	ad|verteren	venteeren	verteren
aeen hoeren	aan|horen	hoeren	horen
aef treck	af|trekken	treck	trekken
aen bevolen	aan|bevelen	bevolen	bevelen
aen bieden	aan|bieden	bieden	bieden
aen biedt	aan|bieden	biedt	bieden
aen brengen	aan|brengen	brengen	brengen
aen comt	aan|komen	comt	komen
aen dienen	aan|dienen	dienen	dienen
aen doen	aan|doen	doen	doen
aen doit	aan|doen	doit	doen
aen gaat	aan|gaan	gaat	gaan
aen gaedt	aan|gaan	gaedt	gaan
aen gaen	aan|gaan	gaen	gaan
aen gaende	aan|gaan	gaende	gaan
aen gaet	aan|gaan	gaet	gaan
Aen gaet	aan|gaan	gaet	gaan
aen gebeden	aan|bidden	gebeden	bidden
aen gebracht	brengen|aan	aen	brengen
aen gedaen	aan|doen	gedaen	doen
aen gehaelt	aan|halen	gehaelt	halen
aen gekomen	aan|komen	gekomen	komen
aen geleid	aan|leiden	geleid	leiden
aen genomen	aan|nemen	genomen	nemen
aen gerloope	aan|lopen	gerloope	lopen
aen geseijt	aan|zeggen	geseijt	zeggen
aen gesproken	aan|spreken	gesproken	spreken
aen getast	aan|tasten	getast	tasten
aen ghet	aan|gaan	ghet	gaan
aen hangen	aan|hangen	hangen	hangen
aen heeft	aan|hebben	heeft	hebben
aen hooren	aan|horen	hooren	horen
Aen hooren	aan|horen	hooren	horen
aen hovwen	aan|houden	hovwen	houden
aen komen	aan|komen	komen	komen
aen komt	aan|komen	komt	komen
aen leggen	aan|leggen	leggen	leggen
aen loopen	aan|lopen	loopen	lopen
aen lopen	aan|lopen	lopen	lopen
aen neemen	aan|nemen	neemen	nemen
aen nemen	aan|nemen	nemen	nemen
aen planten	aan|planten	planten	planten
aen porden	aan|porren	porden	porren
aen quam	aan|komen	quam	komen
aen quame	aan|komen	quame	komen
aen saegen	aan|zien	saegen	zien
aen schouuen	aan|schouwen	schouuen	schouwen
aen schouwen	aan|schouwen	schouwen	schouwen
aen scouwen	aan|schouwen	scouwen	schouwen
Aen setten	aan|zetten	setten	zetten
aen sie	aan|zien	sie	zien
aen sijen	aan|zien	sijen	zien
aen spreecken	aan|spreken	spreecken	spreken
aen staedt	aan|staan	staedt	staan
aen staen	aan|staan	staen	staan
aen staet	aan|staan	staet	staan
aen stellen	aan|stellen	stellen	stellen
aen tasten	aan|tasten	tasten	tasten
aen teeckenen	aan|tekenen	teeckenen	tekenen
aen treffe	aan|treffen	treffe	treffen
aen vaerden	aan|vaarden	vaerden	vaarden
aen wenden	aan|wenden	wenden	wenden
aen wenschen	aan|wensen	wenschen	wensen
aen wijsen	aan|wijzen	wijsen	wijzen
af betaale	af|betalen	betaale	betalen
af breckende	af|breken	breckende	breken
af breeckend	af|breken	breeckend	breken
af breeke	af|breken	breeke	breken
af breeken	af|breken	breeken	breken
af breekende	af|breken	breekende	breken
af Breekende	af|breken	Breekende	breken
af brek	af|breken	brek	breken
af breken	af|breken	breken	breken
af com	af|komen	com	komen
af doen	af|doen	doen	doen
af eyssen	af|eisen	eyssen	eisen
aff Gaen	af|gaan	Gaen	gaan
aff geeven	af|geven	geeven	geven
aff geft	af|geven	geft	geven
aff gekort	af|korten	gekort	korten
aff gerake	af|geraken	gerake	geraken
aff gesonden	af|zenden	gesonden	zenden
aff komen	af|komen	komen	komen
Aff Laaden	af|laden	Laaden	laden
aff racke	af|raken	racke	raken
aff sien	af|zien	sien	zien
aff stelen	af|stellen	stelen	stellen
aff trekken	af|trekken	trekken	trekken
af gaan	af|gaan	gaan	gaan
af gaat	af|gaan	gaat	gaan
af gaet	af|gaan	gaet	gaan
af gebrant	af|branden	gebrant	branden
af gedaan	af|doen	gedaan	doen
af gedaen	af|doen	gedaen	doen
af gedan	af|doen	gedan	doen
af gedanckt	af|danken	gedanckt	danken
Af ge eijst	af|eisen	eijst	eisen
Af geeven	af|geven	geeven	geven
af gehouden	af|houden	gehouden	houden
af gekomen	af|komen	gekomen	komen
af gekoomen	af|komen	gekoomen	komen
af geloopen	af|lopen	geloopen	lopen
af genomen	af|nemen	genomen	nemen
af geraaden	af|raden	geraaden	raden
af gereden	af|rijden	gereden	rijden
af geschreeven	af|schrijven	geschreeven	schrijven
af gesien	af|zien	gesien	zien
af ge sneden	af|snijden	sneden	snijden
Af gesneden	af|snijden	gesneden	snijden
af Gesonde	af|zenden	Gesonde	zenden
af gesonden	af|zenden	gesonden	zenden
af getrocken	af|trekken	getrocken	trekken
af geveijlt	af|vijlen	geveijlt	vijlen
af geven	af|geven	geven	geven
af geweesen	af|wijzen	geweesen	wijzen
af gheloopen	af|lopen	gheloopen	lopen
af ging	af|gaan	ging	gaan
af gooijd	af|gooien	gooijd	gooien
af haalen	af|halen	haalen	halen
af hangen	af|hangen	hangen	hangen
af keeren	af|keren	keeren	keren
af keuren	af|keuren	keuren	keuren
af komen	af|komen	komen	komen
af kommen	af|komen	kommen	komen
af koomen	af|komen	koomen	komen
af kregen	af|krijgen	kregen	krijgen
af kunne	af|kunnen	kunne	kunnen
af Laden	af|laden	Laden	laden
af leggen	af|leggen	leggen	leggen
af loopen	af|lopen	loopen	lopen
af lopen	af|lopen	lopen	lopen
af neemen	af|nemen	neemen	nemen
af nemen	af|nemen	nemen	nemen
af schepe	af|schepen	schepe	schepen
af schilfere	af|schilferen	schilfere	schilferen
af Schrijven	af|schrijven	Schrijven	schrijven
af senden	af|zenden	senden	zenden
af smeeken	af|smeken	smeeken	smeken
af snijden	af|snijden	snijden	snijden
af staappen	af|stappen	staappen	stappen
af tappen	af|tappen	tappen	tappen
after blijeft	achter|blijven	blijeft	blijven
aft ghekordt	af|korten	ghekordt	korten
af Veijlen	af|veilen	Veijlen	veilen
af voordere	af|vorderen	voordere	vorderen
af vorderen	af|vorderen	vorderen	vorderen
af wachten	af|wachten	wachten	wachten
af wagten	af|wachten	wagten	wachten
af wegen	af|wegen	wegen	wegen
af wenden	af|wenden	wenden	wenden
af zenden	af|zenden	zenden	zenden
af Zenden	af|zenden	Zenden	zenden
Af zenden	af|zenden	zenden	zenden
af zien	af|zien	zien	zien
af Zien	af|zien	Zien	zien
agter blyven	achter|blijven	blyven	blijven
agter gaan	achter|gaan	gaan	gaan
agter gelatene	achter|laten	gelatene	laten
agter uijt	achter|uitteren	uijt	uitteren
agter Uyt	achter|uitzien	Uyt	uitzien
agteruyt gaan	achter|uitgaan	gaan	uitgaan
agteruyt gegaan	achter|uitgaan	gegaan	uitgaan
al	weder|omhebben	al	omhebben
an belang	aan|belangen	belang	belangen
anbe langet	aan|belangen	langet	belangen
an belangt	aan|belangen	belangt	belangen
an betreft	aan|betreffen	betreft	betreffen
an bevolen	aan|bevelen	bevolen	bevelen
an Gaad	aan|gaan	Gaad	gaan
an gaat	aan|gaan	gaat	gaan
an gad	aan|gaan	gad	gaan
an Gad	aan|gaan	Gad	gaan
an gaet	aan|gaan	gaet	gaan
an genoomen	aan|nemen	genoomen	nemen
an getast	aan|tasten	getast	tasten
an horen	aan|horen	horen	horen
an koomen	aan|komen	koomen	komen
an ruepen	aan|roepen	ruepen	roepen
An Schouwen	aan|schouwen	Schouwen	schouwen
an trefen	aan|treffen	trefen	treffen
an treffe	aan|treffen	treffe	treffen
an treffen	aan|treffen	treffen	treffen
ant woorden	ant|woorden	woorden	woorden
auer kaemen	over|komen	kaemen	komen
be bedencken	be|denken	bedencken	denken
becendt maecke	bekend|maken	maecke	maken
becent gemaeckt	bekend|maken	gemaeckt	maken
becent maecken	bekend|maken	maecken	maken
be commen	be|komen	commen	komen
be dancken	be|danken	dancken	danken
be droeue	be|droeven	droeue	droeven
beet gehat	beet|hebben	gehat	hebben
bee waert	be|waren	waert	waren
be gendt	be|ginnen	gendt	ginnen
be gonsten	be|ginnen	gonsten	ginnen
be graeve	be|graven	graeve	graven
be hagt	be|hagen	hagt	hagen
be handigen	be|handigen	handigen	handigen
be han dige	voort|be|handigen	dige	handigen
be handige	voort|be|handigen	handige	handigen
be handijgen	be|handigen	handijgen	handigen
be handijngen	be|handigen	handijngen	handigen
be houue	be|houden	houue	houden
beijten slijten	buiten|sluiten	slijten	sluiten
bekend maaken	bekend|maken	maaken	maken
Bekend maaken	bekend|maken	maaken	maken
bekendt gemackt	bekend|maken	gemackt	maken
bekendt maken	bekend|maken	maken	maken
bekent gemaackt	bekend|maken	gemaackt	maken
bekent gemaakt	bekend|maken	gemaakt	maken
bekent gemackt	bekend|maken	gemackt	maken
bekent gemaeckt	bekend|maken	gemaeckt	maken
bekent maaken	bekend|maken	maaken	maken
bekent Maaken	bekend|maken	Maaken	maken
bekent macken	bekend|maken	macken	maken
bekent maecken	bekend|maken	maecken	maken
bekent maeken	bekend|maken	maeken	maken
bekent maken	bekend|maken	maken	maken
be koemen	be|komen	koemen	komen
be leeft	be|leven	leeft	leven
be leuen	be|leven	leuen	leven
be lif	be|lieven	lif	lieven
be lijeft	be|lieven	lijeft	lieven
be looft	be|loven	looft	loven
be mint	be|minnen	mint	minnen
benarich ten	be|na|richten	ten	richten
bennen gecomen	binnen|komen	gecomen	komen
bennen geloopen	binnen|lopen	geloopen	lopen
be schrijeuen	be|schrijven	schrijeuen	schrijven
be schrijve	be|schrijven	schrijve	schrijven
besock en	be|zoeken	en	zoeken
be stellen	be|stellen	stellen	stellen
bestel len	be|stellen	len	stellen
be taelen	be|talen	taelen	talen
bet aellen	be|talen	aellen	talen
be taelt	be|talen	taelt	talen
be talen	be|talen	talen	talen
be treft	be|treffen	treft	treffen
be tuijgen	be|tuigen	tuijgen	tuigen
be uelen	be|velen	uelen	velen
beue len	be|velen	len	velen
Beurt op	beuren|op	Beurt	beuren
be vaert	be|waren	vaert	waren
be vint	be|vinden	vint	vinden
be vogte	be|vechten	vogte	vechten
be volen	be|velen	volen	velen
be voolen	be|velen	voolen	velen
Be waare	be|waren	waare	waren
be waart	be|waren	waart	waren
be waeren	be|waren	waeren	waren
be waert	be|waren	waert	waren
be waren	be|waren	waren	waren
be wege	be|wegen	wege	wegen
be wegen	be|wegen	wegen	wegen
bewy se	be|wijzen	se	wijzen
bidde toe	bidden|toe	bidde	bidden
bij	bij|brengen	bij	brengen
bij blijven	bij|blijven	blijven	blijven
bij blyven	bij|blijven	blyven	blijven
bij brengen	bij|brengen	brengen	brengen
bij brenghen	bij|brengen	brenghen	brengen
bij comen	bij|komen	comen	komen
bij commen	bij|komen	commen	komen
bij compt	bij|komen	compt	komen
bij comt	bij|komen	comt	komen
bij een blijven	bijeen|blijven	blijven	blijven
bij een brengen	bijeen|brengen	brengen	brengen
bij een brigen	bijeen|brengen	brigen	brengen
bij een crijgen	bijeen|krijgen	crijgen	krijgen
bij een gebonde	bijeen|binden	bij	binden
bij een gebracht	bijeen|brengen	een	brengen
bij een komen	bijeen|komen	komen	komen
bij een krijge	bijeen|krijgen	krijge	krijgen
bij een trecken	bijeen|trekken	trecken	trekken
bij een vergadert	bijeen|vergaderen	vergadert	vergaderen
bij een voegen	bijeen|voegen	voegen	voegen
bij gebrogt	bij|brengen	gebrogt	brengen
bij geleijt	bij|leggen	geleijt	leggen
bij gewoondt	bij|wonen	gewoondt	wonen
bij gewoont	bij|wonen	gewoont	wonen
bij komen	bij|komen	komen	komen
bij koomen	bij|komen	koomen	komen
bij krijgen	bij|krijgen	krijgen	krijgen
bij legen	bij|leggen	legen	leggen
bij setten	bij|zetten	setten	zetten
bij sluijten	bij|sluiten	sluijten	sluiten
bij staan	bij|staan	staan	staan
Bij staan	bij|staan	staan	staan
bij staen	bij|staan	staen	staan
bij staet	bij|staan	staet	staan
bij wone	bij|wonen	wone	wonen
bij woonen	bij|wonen	woonen	wonen
binen gekomen	binnen|komen	gekomen	komen
Binen gekoomen	binnen|komen	gekoomen	komen
binne gesleept	binnen|slepen	gesleept	slepen
binne getreede	binnen|treden	getreede	treden
binne komen	binnen|komen	komen	komen
binne kwam	binnen|komen	kwam	komen
binnen comen	binnen|komen	comen	komen
binnen coomen	binnen|komen	coomen	komen
binnen gekomen	binnen|komen	gekomen	komen
binnen Gekomen	binnen|komen	Gekomen	komen
binnen gekommen	binnen|komen	gekommen	komen
binnen gekoomem	binnen|komen	gekoomem	komen
binnen Gekoomen	binnen|komen	Gekoomen	komen
Binnen gekoomen	binnen|komen	gekoomen	komen
binnen geroepen	binnen|roepen	geroepen	roepen
binnen ghe koomen	binnen|komen	koomen	komen
binnen komen	binnen|komen	komen	komen
binnen komt	binnen|komen	komt	komen
binnen quamen	binnen|komen	quamen	komen
bloot staan	bloot|staan	staan	staan
blyft naa	blijven|na	blyft	blijven
blyft over	blijven|over	blyft	blijven
boven drijven	boven|drijven	drijven	drijven
bracht meede	brengen|mee	bracht	brengen
bragt aan	brengen|aan	bragt	brengen
bragte door	brengen|door	bragte	brengen
breckeden af	breken|af	breckeden	breken
breck of	breken|af	breck	breken
breckt of	breken|af	breckt	breken
breecke af	breken|af	breecke	breken
Breeg af	breken|af	Breeg	breken
breek af	breken|af	breek	breken
Breek af	breken|af	Breek	breken
Breek Af	breken|af	Breek	breken
breek aff	breken|af	breek	breken
Breek aff	breken|af	Breek	breken
breek aft	breken|af	breek	breken
breeke af	breken|af	breeke	breken
Breeke af	breken|af	Breeke	breken
Breekende af	breken|af	Breekende	breken
Breeke of	breken|af	Breeke	breken
breek hf	breken|af	breek	breken
breek of	breken|af	breek	breken
breekt af	breken|af	breekt	breken
breekt door	breken|door	breekt	breken
breekt of	breken|af	breekt	breken
brek af	breken|af	brek	breken
breke af	breken|af	breke	breken
breken of	breken|af	breken	breken
brenckt me	brengen|mee	brenckt	brengen
brengd voort	brengen|voort	brengd	brengen
brenge ver	brengen|weder	brenge	brengen
brengh mee	brengen|mee	brengh	brengen
brenght mede	brengen|mee	brenght	brengen
brenght meede	brengen|mee	brenght	brengen
brengt mede	brengen|mee	brengt	brengen
brengt mee	brengen|mee	brengt	brengen
brent me	brengen|mee	brent	brengen
bringe aen	brengen|aan	bringe	brengen
buijten sluijten	buiten|sluiten	sluijten	sluiten
by brengen	bij|brengen	brengen	brengen
by een	bijeen|krijgen	een	krijgen
By een koemen	bijeen|komen	koemen	komen
by gekomen	bij|komen	gekomen	komen
by gestaan	bij|staan	gestaan	staan
by gestaen	bij|staan	gestaen	staan
by gewoond	bij|wonen	gewoond	wonen
by sette	bij|zetten	sette	zetten
by stan	bij|staan	stan	staan
Casseert in	casseren|in	Casseert	casseren
claer leggen	klaar|liggen	leggen	liggen
claer raken	klaar|raken	raken	raken
clear raeken	klaar|raken	raeken	raken
comdt tuis	komen|thuis	comdt	komen
comen aen	komen|aan	comen	komen
comen thuijs	komen|thuis	comen	komen
come tues	komen|thuis	come	komen
com mede	komen|mee	com	komen
compt toe	komen|toe	compt	komen
comt aen	komen|aan	comt	komen
comt bij	komen|bij	comt	komen
comt over	komen|over	comt	komen
comt tehuys	komen|thuis	comt	komen
comt toe	komen|toe	comt	komen
comt tuijs	komen|thuis	comt	komen
coomen te huis	komen|thuis	coomen	komen
coome thuys	komen|thuis	coome	komen
daal neder	dalen|neder	daal	dalen
dank segge	dank|zeggen	segge	zeggen
deed aan	doen|aan	deed	doen
deel neemen	deel|nemen	neemen	nemen
deel nemen	deel|nemen	nemen	nemen
deel nemt	deel|nemen	nemt	nemen
deelt mede	delen|mee	deelt	delen
de huijs komme	thuis|komen	komme	komen
de kort doen	tekort|doen	doen	doen
delvde op	delven|op	delvde	delven
der gaet	door|gaan	gaet	gaan
der	uit|halen	der	halen
deur gecomen	door|komen	gecomen	komen
dicht maecken	dicht|maken	maecken	maken
diende aan	dienen|aan	diende	dienen
dijcht gehouden	dicht|houden	gehouden	houden
dmeede ghenoomen	mee|nemen	ghenoomen	nemen
doed aan	doen|aan	doed	doen
doedt geschoten	dood|schieten	geschoten	schieten
doedt wel	doen|wel	doedt	doen
doen aan	doen|aan	doen	doen
doen aen	doen|aan	doen	doen
doer koemen	door|komen	koemen	komen
doet aan	doen|aan	doet	doen
doet hopen	doen|open	doet	doen
doet te kort	doen|tekort	doet	doen
doet uijt	doen|uit	doet	doen
doet wel	doen|wel	doet	doen
dood gebeten	dood|bijten	gebeten	bijten
dood slaan	dood|slaan	slaan	slaan
doodt gesmeten	dood|smijten	gesmeten	smijten
door brenge	door|brengen	brenge	brengen
door brengen	door|brengen	brengen	brengen
door gaan	door|gaan	gaan	gaan
door gebracht	door|brengen	gebracht	brengen
door gebragt	door|brengen	gebragt	brengen
door gebroocken	door|breken	gebroocken	breken
door gegaen	door|gaan	gegaen	gaan
door gestaan	door|staan	gestaan	staan
door kijcken	door|kijken	kijcken	kijken
door koemen	door|komen	koemen	komen
door komen	door|komen	komen	komen
door schakert	door|schakeren	schakert	schakeren
doot Gebleeven	dood|blijven	Gebleeven	blijven
doot geschooten	dood|schieten	geschooten	schieten
doot geschoten	dood|schieten	geschoten	schieten
doot geslagen	dood|slaan	geslagen	slaan
doot gevalle	dood|vallen	gevalle	vallen
doot gevallen	dood|vallen	gevallen	vallen
doot gheschoeten	dood|schieten	gheschoeten	schieten
doot schooten	dood|schieten	schooten	schieten
doot schoten	dood|schieten	schoten	schieten
dor sijen	door|zien	sijen	zien
dragt voor	dragen|voor	dragt	dragen
dref op	drijven|op	dref	drijven
droogd aff	drogen|af	droogd	drogen
droog krijgen	droog|krijgen	krijgen	krijgen
duer gaen	door|gaan	gaen	gaan
duijer kommen	door|komen	kommen	komen
Eens koomen	eens|komen	koomen	komen
en gelopen	in|lopen	gelopen	lopen
en ship t	in|schepen	ship	schepen
er steeld	her|stellen	steeld	stellen
er uit zag	er|uit|zien	zag	zien
er uitzien	er|uit|zien	er	zien
Euth stan	uit|staan	stan	staan
ex pedieeren	ex|pediëren	pedieeren	pediëren
fer staen	ver|staan	staen	staan
fluijt schip	fluit|schip	schip	schip
foor looren	ver|liezen	looren	liezen
gaa meede	gaan|mee	gaa	gaan
gaan heenen	gaan|heen	gaan	gaan
gaan mee	gaan|mee	gaan	gaan
gaan over	gaan|over	gaan	gaan
gaan uydt	gaan|uit	gaan	gaan
gaan uyt	gaan|uit	gaan	gaan
Gaan uyt	gaan|uit	Gaan	gaan
gaan Voort	gaan|voort	gaan	gaan
gaat aan	gaan|aan	gaat	gaan
gaat an	gaan|aan	gaat	gaan
gaat heen	gaan|heen	gaat	gaan
gaat Meede	gaan|mee	gaat	gaan
gaat mee	gaan|mee	gaat	gaan
gaat oope	gaan|open	gaat	gaan
gaat voord	gaan|voort	gaat	gaan
gaat voort	gaan|voort	gaat	gaan
gaat voor uijt	gaan|vooruit	gaat	gaan
gaat wel	gaan|wel	gaat	gaan
gaa voord	gaan|voort	gaa	gaan
gaa wel	gaan|wel	gaa	gaan
gaedt	gaan|toe	gaedt	gaan
gaedt wel	gaan|wel	gaedt	gaan
gaende over	gaan|over	gaende	gaan
gaen mee	gaan|mee	gaen	gaan
gaen om	gaan|om	gaen	gaan
gaen over	gaan|over	gaen	gaan
gaen voort	gaan|voort	gaen	gaan
gaen voor	gaan|voor	gaen	gaan
gaen wecht	gaan|weg	gaen	gaan
gaen wel	gaan|wel	gaen	gaan
gaet aen	gaan|aan	gaet	gaan
gaet an	gaan|aan	gaet	gaan
gaet of	gaan|af	gaet	gaan
gaet om	gaan|om	gaet	gaan
gaet open	gaan|open	gaet	gaan
gaet ouer	gaan|over	gaet	gaan
gaet school	gaan|school	gaet	gaan
gaet toe	gaan|toe	gaet	gaan
gaet uit	gaan|uit	gaet	gaan
gaet voort	gaan|voort	gaet	gaan
gaet wel	gaan|wel	gaet	gaan
gaff terug	geven|terug	gaff	geven
gaf in	geven|in	gaf	geven
gaf meede	geven|mee	gaf	geven
gaf over	geven|over	gaf	geven
ga oover	gaan|over	ga	gaan
gat heenen	gaan|heen	gat	gaan
gat schol	gaan|school	gat	gaan
ga voorby	gaan|voorbij	ga	gaan
Ga Voort	gaan|voort	Ga	gaan
ge aduijs t	ad|viseren	ge	viseren
geaduijs t	ad|viseren	t	viseren
ge antwoord	ant|woorden	antwoord	woorden
ge bevrt	ge|beuren	bevrt	beuren
gebruijk maken	gebruik|maken	maken	maken
gebruijkt maken	gebruik|maken	maken	maken
gebruik maaken	gebruik|maken	maaken	maken
ge bruyke	ge|bruiken	bruyke	bruiken
gebryk maake	gebruik|maken	maake	maken
ge bvert	ge|beuren	bvert	beuren
gedag seggen	gedag|zeggen	seggen	zeggen
geeft op	geven|op	geeft	geven
geeft over	geven|over	geeft	geven
geeft Over	geven|over	geeft	geven
Geeft over	geven|over	Geeft	geven
geen voort	gaan|voort	geen	gaan
geeuer gennen	ver|gunnen	gennen	gunnen
geeve op	geven|op	geeve	geven
geft toe	geven|toe	geft	geven
ge goiet	uit|gooien	goiet	gooien
ge houden	op|houden	houden	houden
ge lef	ge|lieven	lef	lieven
ge lieft	ge|lieven	lieft	lieven
Ge loft	ge|loven	loft	loven
ge loove	ge|loven	loove	loven
Geluk wensche	geluk|wensen	wensche	wensen
genacht gezegd	genacht|zeggen	gezegd	zeggen
genacht segge	genacht|zeggen	segge	zeggen
genacht seggen	genacht|zeggen	seggen	zeggen
genacht segg	genacht|zeggen	segg	zeggen
ge nietende	ge|nieten	nietende	nieten
genoech doen	genoeg|doen	doen	doen
ge recomendert	re|commanderen	recomendert	commanderen
gerecom mandeert	re|commanderen	mandeert	commanderen
gereed legge	gereed|leggen	legge	leggen
gereed leggen	gereed|leggen	leggen	leggen
gereed maaken	gereed|maken	maaken	maken
gereed staan	gereed|staan	staan	staan
gereet legge	gereed|liggen	legge	liggen
gereet leyt	gereed|liggen	leyt	liggen
gereet liggen	gereed|liggen	liggen	liggen
gereet maken	gereed|maken	maken	maken
Gereet maken	gereed|maken	maken	maken
gerust stellen	gerust|stellen	stellen	stellen
ge schide	ge|schieden	schide	schieden
gevangen setten	gevangen|zetten	setten	zetten
ge vetten	ge|weten	vetten	weten
ge Waarschout	waar|schuwen	Waarschout	schuwen
gewaar worden	gewaar|worden	worden	worden
Gewaar worden	gewaar|worden	worden	worden
gewaer wijerde	gewaar|worden	wijerde	worden
gewaer wort	gewaar|worden	wort	worden
ge warscot	waar|schuwen	warscot	schuwen
ghenoet sackt	nood|zaken	sackt	zaken
gijen bijnnen	gaan|binnen	gijen	gaan
ginck uijt	gaan|uit	ginck	gaan
gingen over	gaan|over	gingen	gaan
gingh binnen	gaan|binnen	gingh	gaan
gingh heen	gaan|heen	gingh	gaan
ging mede	gaan|mee	ging	gaan
ging weg	gaan|weg	ging	gaan
git om	gaan|om	git	gaan
g l	ge|leiden	l	leiden
goedden nacht	goede|zeggen|nacht	goedden	zeggen
goede na[…]cat	goede|nacht|zeggen	goede	zeggen
goede nach	goede|nacht|zeggen	goede	zeggen
goede nachten seggen	goede|nacht|zeggen	seggen	zeggen
goede nacht	goede|nacht|zeggen	goede	zeggen
Goede nacht	goede|nacht|zeggen	Goede	zeggen
goede nacht segge	goede|nacht|zeggen	segge	zeggen
goede nacht seggen	goede|nacht|zeggen	seggen	zeggen
goede nacht seghgen	goede|nacht|zeggen	seghgen	zeggen
goedenacht seijt	goede|nacht|zeggen	seijt	zeggen
goede naect	goede|nacht|zeggen	goede	zeggen
goede naght	goede|nacht|zeggen	goede	zeggen
goede naght seght	goede|nacht|zeggen	seght	zeggen
goeden nach	goede|zeggen|nacht	goeden	zeggen
goeden nacht	goede|zeggen|nacht	goeden	zeggen
goeden nacht seggen	goede|nacht|zeggen	seggen	zeggen
goeden nacht seghen	goede|nacht|zeggen	seghen	zeggen
goeden naeght	goede|zeggen|nacht	goeden	zeggen
goed gemaakt	goed|maken	gemaakt	maken
goed gevonden	goed|vinden	gevonden	vinden
goed maaken	goed|maken	maaken	maken
goed maken	goed|maken	maken	maken
goedt gevonde	goed|vinden	gevonde	vinden
goedt maacken	goed|maken	maacken	maken
goed vind	goed|vinden	vind	vinden
Goed Vind	goed|vinden	Vind	vinden
goe nach seggen	goede|nacht|zeggen	seggen	zeggen
goet doen	goed|doen	doen	doen
goet duncken	goed|dunken	duncken	dunken
goet dunck	goed|dunken	dunck	dunken
goet gesproken	goed|spreken	gesproken	spreken
goet maak	goed|maken	maak	maken
goet vind	goed|vinden	vind	vinden
goet vindt	goed|vinden	vindt	vinden
goet vint	goed|vinden	vint	vinden
goet vonden	goed|vinden	vonden	vinden
gong voort	gaan|voort	gong	gaan
groot brengen	groot|brengen	brengen	brengen
groot maeckene	groot|maken	maeckene	maken
haangt uyt	hangen|uit	haangt	hangen
hachterom Comen	achter|omkomen	Comen	omkomen
hadde op	hebben|op	hadde	hebben
haelt op	halen|op	haelt	halen
hangt af	hangen|af	hangt	hangen
han treffen	aan|treffen	treffen	treffen
haut aen	houden|aan	haut	houden
hebbe af	hebben|af	hebbe	hebben
hebbe in	hebben|in	hebbe	hebben
hebben in	hebben|in	hebben	hebben
hebben Jn	hebben|in	hebben	hebben
hebben lief	hebben|lief	hebben	hebben
hebben vor	hebben|voor	hebben	hebben
heb in	hebben|in	heb	hebben
heb lief	hebben|lief	heb	hebben
heb lijef	hebben|lief	heb	hebben
heb lijff	hebben|lief	heb	hebben
hebt liev	hebben|lief	hebt	hebben
heeft in	hebben|in	heeft	hebben
heeft Jn	hebben|in	heeft	hebben
heeft over	hebben|over	heeft	hebben
heeft plaats	hebben|plaats	heeft	hebben
heen dwaalde	heen|dwalen	dwaalde	dwalen
heene gaen	heen|gaan	gaen	gaan
heene gevloogen	heen|vliegen	gevloogen	vliegen
heen gaen	heen|gaan	gaen	gaan
heen gesonde	heen|zenden	gesonde	zenden
heen ging	heen|gaan	ging	gaan
helpt te reche	helpen|terecht	helpt	helpen
helpt te recht	helpen|terecht	helpt	helpen
hen gan	heen|gaan	gan	gaan
hen vaare	heen|varen	vaare	varen
her stellen	her|stellen	stellen	stellen
het lyef	hebben|lief	het	hebben
het mee	hebben|mede	het	hebben
heuijs houden	huis|houden	houden	houden
hielt over	houden|over	hielt	houden
hier Innert	her|inneren	Innert	inneren
hier	mee|brengen	hier	brengen
hoor toe	horen|toe	hoor	horen
hoout op	houden|op	hoout	houden
hort toe	horen|toe	hort	horen
hou aan	houden|aan	hou	houden
houde aen	houden|aan	houde	houden
houden op	houden|op	houden	houden
houdt aan	houden|aan	houdt	houden
houdt op	houden|op	houdt	houden
houdt vaest	houden|vast	houdt	houden
hou op	houden|op	hou	houden
hout op	houden|op	hout	houden
houwe	af|houden	houwe	houden
huet staen	uit|staan	staen	staan
huijs houden	huis|houden	houden	houden
huijt gaen	uit|gaan	gaen	gaan
huijt gegan	uit|gaan	gegan	gaan
hut ghevoerdt	uit|voeren	ghevoerdt	voeren
huys houwen	huis|houden	houwen	houden
ijn gegaert	in|garen	gegaert	garen
ijn genoemen	in|nemen	genoemen	nemen
ijn heben	in|hebben	heben	hebben
ijn neemen	in|nemen	neemen	nemen
in Aebben	in|hebben	Aebben	hebben
in beelden	in|beelden	beelden	beelden
in boesemen	in|boezemen	boesemen	boezemen
in bragt	in|brengen	bragt	brengen
in coopen	in|kopen	coopen	kopen
in Crijgen	in|krijgen	Crijgen	krijgen
in gaen	in|gaan	gaen	gaan
in gecomen	in|komen	gecomen	komen
in gedrukt	in|drukken	gedrukt	drukken
in geenomen	in|nemen	geenomen	nemen
in gegeven	in|geven	gegeven	geven
in gekomen	in|komen	gekomen	komen
in gekommen	in|komen	gekommen	komen
in gekoome	in|komen	gekoome	komen
in gekoomen	in|komen	gekoomen	komen
in Geladen	in|laden	Geladen	laden
in gelaten	in|laten	gelaten	laten
in gelegen	in|liggen	gelegen	liggen
in geloopen	in|lopen	geloopen	lopen
in gelopen	in|lopen	gelopen	lopen
in ge nome	in|nemen	nome	nemen
in genomen	in|nemen	genomen	nemen
in genoomen	in|nemen	genoomen	nemen
in gepackt	in|pakken	gepackt	pakken
in gerigt	in|richten	gerigt	richten
in geschote	in|schieten	geschote	schieten
in geslaagen	in|slaan	geslaagen	slaan
in geslaag	in|slaan	geslaag	slaan
in geslagen	in|slaan	geslagen	slaan
in gesleep	in|slepen	gesleep	slepen
in ghenomen	in|nemen	ghenomen	nemen
in haalen	in|halen	haalen	halen
In hadde	in|hebben	hadde	hebben
in haede	in|hebben	haede	hebben
in halen	in|halen	halen	halen
in hebbende	in|hebben	hebbende	hebben
In hebbende	in|hebben	hebbende	hebben
In hebben	in|hebben	hebben	hebben
in heben	in|hebben	heben	hebben
in hebt	in|hebben	hebt	hebben
in heeft	in|hebben	heeft	hebben
in huuren	in|huren	huuren	huren
in Kaaseert	in|casseren	Kaaseert	casseren
in komen	in|komen	komen	komen
in koopen	in|kopen	koopen	kopen
In krijge	in|krijgen	krijge	krijgen
in krijghe	in|krijgen	krijghe	krijgen
in kwaam	in|komen	kwaam	komen
in laaden	in|laden	laaden	laden
in laden	in|laden	laden	laden
in laet	in|laden	laet	laden
in manen	in|manen	manen	manen
in neemen	in|nemen	neemen	nemen
In neemen	in|nemen	neemen	nemen
in nemen	in|nemen	nemen	nemen
in Pakken	in|pakken	Pakken	pakken
in schepen	in|schepen	schepen	schepen
In schepen	in|schepen	schepen	schepen
in scherpen	in|scherpen	scherpen	scherpen
in senden	in|zenden	senden	zenden
in sinueeren	in|sinueren	sinueeren	sinueren
in slaan	in|slaan	slaan	slaan
in steeken	in|steken	steeken	steken
instem mende	in|stemmen	mende	stemmen
int fangen	ont|vangen	fangen	vangen
int ge nomen	in|nemen	nomen	nemen
in voorderen	in|vorderen	voorderen	vorderen
in vorderen	in|vorderen	vorderen	vorderen
in waaijen	in|waaien	waaijen	waaien
in wikkele	in|wikkelen	wikkele	wikkelen
in woonen	in|wonen	woonen	wonen
in zetten	in|zetten	zetten	zetten
jn geladen	in|laden	geladen	laden
Jn geladen	in|laden	geladen	laden
Jn Gelopen	in|lopen	Gelopen	lopen
jn neemt	in|nemen	neemt	nemen
jnvoor meeren	in|formeren	meeren	formeren
jn vorderen	in|vorderen	vorderen	vorderen
kam tus	komen|thuis	kam	komen
kast stijt	kas|tijden	stijt	tijden
keerde in	keren|in	keerde	keren
klaar komen	klaar|komen	komen	komen
Klaar komen	klaar|komen	komen	komen
klaar koome	klaar|komen	koome	komen
klaar koomen	klaar|komen	koomen	komen
klaar kreijgen	klaar|krijgen	kreijgen	krijgen
klaar krijge	klaar|krijgen	krijge	krijgen
klaar lijt	klaar|liggen	lijt	liggen
klaar Lijt	klaar|liggen	Lijt	liggen
klaar maaken	klaar|maken	maaken	maken
klaar raaken	klaar|raken	raaken	raken
klaar Raaken	klaar|raken	Raaken	raken
Klaar Raaken	klaar|raken	Raaken	raken
klaer	klaar|liggen	klaer	liggen
klaer leggen	klaar|liggen	leggen	liggen
klaer liggen	klaar|liggen	liggen	liggen
klaer maeken	klaar|maken	maeken	maken
klaer raecken	klaar|raken	raecken	raken
klaer Raeken	klaar|raken	Raeken	raken
klaer raken	klaar|raken	raken	raken
komen aen	komen|aan	komen	komen
komen te huijs	komen|thuis	komen	komen
komen	thuis|komen	komen	komen
komen t’hus	komen|thuis	komen	komen
komen weder om	omkomen|weder	komen	omkomen
kome t’hus	komen|thuis	kome	komen
kome thuys	komen|thuis	kome	komen
komt aan	komen|aan	komt	komen
komt	aan|komen	komt	komen
komt aen	komen|aan	komt	komen
komt an	komen|aan	komt	komen
komt benne	komen|binnen	komt	komen
komt meede	komen|mee	komt	komen
komt of	komen|af	komt	komen
komt over	komen|over	komt	komen
komt te huijs	komen|thuis	komt	komen
komt te huis	komen|thuis	komt	komen
komt te kort	komen|tekort	komt	komen
komt te regt	komen|terecht	komt	komen
komt thuys	komen|thuis	komt	komen
komt toe	komen|toe	komt	komen
komt tuhijs	komen|thuis	komt	komen
komt tuijs	komen|thuis	komt	komen
komt tuis	komen|thuis	komt	komen
kom tus	komen|thuis	kom	komen
komt voor	komen|voor	komt	komen
koome na	komen|na	koome	komen
Koome Uyt	komen|uit	Koome	komen
koompt voort	komen|voort	koompt	komen
koomt te regt	komen|terecht	koomt	komen
koomt tuijs	komen|thuis	koomt	komen
koomt voor	komen|voor	koomt	komen
koomt weeder	komen|weder	koomt	komen
korten op	korten|op	korten	korten
kort op	korten|op	kort	korten
krijt wt	krijten|uit	krijt	krijten
krygen	bijeen|krijgen	krygen	krijgen
kwam oop	komen|op	kwam	komen
kwam te huis	komen|thuis	kwam	komen
kwam voor	komen|voor	kwam	komen
kwyt gescholden	kwijt|schelden	gescholden	schelden
kwyt raake	kwijt|raken	raake	raken
laad aff	laden|af	laad	laden
laadt toe	laten|toe	laadt	laten
laaten over	laten|over	laaten	laten
laate uijdt	laten|uit	laate	laten
laat nae	laten|na	laat	laten
laat na	laten|na	laat	laten
Laat na	na|laten	na	laten
laat over	laten|over	laat	laten
Laat over	laten|over	Laat	laten
laat toe	laten|toe	laat	laten
laat Toe	laten|toe	laat	laten
Laat uyt	laten|uit	Laat	laten
laedt nae	laten|na	laedt	laten
laete nae	laten|na	laete	laten
laet nae	laten|na	laet	laten
laet naer	laten|na	laet	laten
Laet naer	laten|na	Laet	laten
laet na	laten|na	laet	laten
laet toe	laten|toe	laet	laten
lam geslaagen	lam|slaan	geslaagen	slaan
lastig gevallen	lastig|vallen	gevallen	vallen
lastigh vallen	lastig|vallen	vallen	vallen
Lastigh vallen	lastig|vallen	vallen	vallen
lastig uaelle	lastig|vallen	uaelle	vallen
lastig val	lastig|vallen	val	vallen
lastig valle	lastig|vallen	valle	vallen
lastig vallen	lastig|vallen	vallen	vallen
Lastig vallen	lastig|vallen	vallen	vallen
laten toe	laten|toe	laten	laten
laten voorbij	laten|voorbij	laten	laten
latt toe	laten|toe	latt	laten
lech gestorven	leeg|sterven	gestorven	sterven
Leeg gelast	leeg|lossen	gelast	lossen
Leeg gelost	leeg|lossen	gelost	lossen
Leeg gestorven	leeg|sterven	gestorven	sterven
Leegh lossen	leeg|lossen	lossen	lossen
leeg sitten	leeg|zitten	sitten	zitten
leerd vooruyt	leren|vooruit	leerd	leren
leest oover	lezen|over	leest	lezen
legge gereet	liggen|gereed	legge	liggen
legge klaar	leggen|klaar	legge	leggen
leggen aen	leggen|aan	leggen	leggen
leggen blood	liggen|bloot	leggen	liggen
leggen op	leggen|op	leggen	leggen
leggen over	leggen|over	leggen	leggen
Leg Klaar	liggen|klaar	Leg	liggen
leijt aen	leggen|aan	leijt	leggen
leverden aen	leveren|aan	leverden	leveren
leydt toe	leggen|toe	leydt	leggen
lge bvert	ge|beuren	bvert	beuren
lick aen	likken|aan	lick	likken
lieff hebbe	lief|hebben	hebbe	hebben
lieff heeft	lief|hebben	heeft	hebben
lief gehad	lief|hebben	gehad	hebben
lief gehadt	lief|hebben	gehadt	hebben
lief hebben	lief|hebben	hebben	hebben
lief hebt	lief|hebben	hebt	hebben
lieft had	lief|hebben	had	hebben
lieft hebben	lief|hebben	hebben	hebben
liepen uijt	lopen|uit	liepen	lopen
liep voor uyt	lopen|vooruit	liep	lopen
liep wegh	lopen|weg	liep	lopen
liet na	laten|na	liet	laten
liev gehad	lief|hebben	gehad	hebben
Liev gehad	lief|hebben	gehad	hebben
liev hebbe	lief|hebben	hebbe	hebben
liev hebben	lief|hebben	hebben	hebben
lijeff hebbe	lief|hebben	hebbe	hebben
lijef hebbe	lief|hebben	hebbe	hebben
lijef hebben	lief|hebben	hebben	hebben
lijef heb	lief|hebben	heb	hebben
lijef heebben	lief|hebben	heebben	hebben
lijef heeft	lief|hebben	heeft	hebben
lijef heft	lief|hebben	heft	hebben
loepen na	lopen|na	loepen	lopen
loept vit	lopen|uit	loept	lopen
Loop rond	lopen|rond	Loop	lopen
loopt los	lopen|los	loopt	lopen
loopt om	lopen|om	loopt	lopen
Loopt teegen	lopen|tegen	Loopt	lopen
loopt t samen	lopen|samen	loopt	lopen
loopt uit	lopen|uit	loopt	lopen
Loos Weercken	los|werken	Weercken	werken
lopt af	lopen|af	lopt	lopen
lopt leegh	lopen|leeg	lopt	lopen
lopt neer	lopen|neer	lopt	lopen
lopt tuijs	lopen|thuis	lopt	lopen
los krijgen	los|krijgen	krijgen	krijgen
los laaten	los|laten	laaten	laten
lost macken	los|maken	macken	maken
lyef heb	lief|hebben	heb	hebben
lyef het	lief|hebben	het	hebben
maak bekendt	maken|bekend	maak	maken
maak bekent	maken|bekend	maak	maken
maake bekend	maken|bekend	maake	maken
maake bekent	maken|bekend	maake	maken
maake wek	maken|weg	maake	maken
maakt bekent	maken|bekend	maakt	maken
maakten vast	maken|vast	maakten	maken
maakte uyt	maken|uit	maakte	maken
maakt uyt	maken|uit	maakt	maken
macken Preis	maken|prijs	macken	maken
mackt gereet	maken|gereed	mackt	maken
mackt klaar	maken|klaar	mackt	maken
maecken claer	maken|klaar	maecken	maken
me brenghen	mee|brengen	brenghen	brengen
medde genomen	mee|nemen	genomen	nemen
mede brenge	mee|brengen	brenge	brengen
Mede Brenge	mee|brengen	Brenge	brengen
mede brengen	mee|brengen	brengen	brengen
mede brenghe	mee|brengen	brenghe	brengen
mede brenghen	mee|brengen	brenghen	brengen
mede bren	mee|brengen	bren	brengen
mede brijen	mee|brengen	brijen	brengen
mede brijngen	mee|brengen	brijngen	brengen
mede comen	mee|komen	comen	komen
mede deelen	mede|delen	deelen	delen
mede deijlen	mede|delen	deijlen	delen
mede doet	mee|doen	doet	doen
mede gaan	mee|gaan	gaan	gaan
mede gaf	mee|geven	gaf	geven
mede gebragt	mee|brengen	gebragt	brengen
mede gebrocht	mee|brengen	gebrocht	brengen
mede gegaen	mee|gaan	gegaen	gaan
mede gegeven	mee|geven	gegeven	geven
mede gekomen	mee|komen	gekomen	komen
mede genome	mee|nemen	genome	nemen
mede genomen	mee|nemen	genomen	nemen
mede genoomen	mee|nemen	genoomen	nemen
mede gesonden	mee|zenden	gesonden	zenden
mede gestijrt	mee|sturen	gestijrt	sturen
mede geue	mee|geven	geue	geven
mede geven	mee|geven	geven	geven
mede hebben	mee|hebben	hebben	hebben
mede heeft	mede|hebben	heeft	hebben
mede helpt	mee|helpen	helpt	helpen
mede komen	mee|komen	komen	komen
mede krijgen	mede|krijgen	krijgen	krijgen
mede krijgt	mee|krijgen	krijgt	krijgen
mede	mee|brengen	mede	brengen
mede nam	mee|nemen	nam	nemen
mede Neme	mee|nemen	Neme	nemen
mede nemende	mee|nemen	nemende	nemen
mede nemen	mee|nemen	nemen	nemen
mede nijnt	mee|nemen	nijnt	nemen
meden krygen	mee|krijgen	krygen	krijgen
meden Neemen	mee|nemen	Neemen	nemen
mede reijien	mee|rijden	reijien	rijden
me doen	mee|doen	doen	doen
mee bracht	mee|brengen	bracht	brengen
mee brengen	mee|brengen	brengen	brengen
mee brochten	mee|brengen	brochten	brengen
meede bengen	mee|brengen	bengen	brengen
meede brenge	mee|brengen	brenge	brengen
Meede brenge	mee|brengen	brenge	brengen
meede brengende	mee|brengen	brengende	brengen
meede brengen	mee|brengen	brengen	brengen
meede deele	mede|delen	deele	delen
meede deelen	mede|delen	deelen	delen
meede delen	mede|delen	delen	delen
meede dregende	mee|dragen	dregende	dragen
meede gebragt	mee|brengen	gebragt	brengen
meede gedeeld	mede|delen	gedeeld	delen
meede geeven	mee|geven	geeven	geven
Meede geeven	mee|geven	geeven	geven
meede gegeeven	mee|geven	gegeeven	geven
meede gegeven	mee|geven	gegeven	geven
meede gekreegen	mee|krijgen	gekreegen	krijgen
meede genomen	mee|nemen	genomen	nemen
meede getrocken	mee|trekken	getrocken	trekken
meede gevaren	mee|varen	gevaren	varen
meede geven	mee|geven	geven	geven
meede Geven	mee|geven	Geven	geven
meede gevoert	mee|voeren	gevoert	voeren
meede komen	mee|komen	komen	komen
meede krijgen	mee|krijgen	krijgen	krijgen
meede neemen	mee|nemen	neemen	nemen
meede neempt	mee|nemen	neempt	nemen
meede senden	mee|zenden	senden	zenden
mee doen	mee|doen	doen	doen
mee gaan	mee|gaan	gaan	gaan
mee Gaan	mee|gaan	Gaan	gaan
Mee gan	mee|gaan	gan	gaan
mee geeve	mee|geven	geeve	geven
mee gefen	mee|geven	gefen	geven
mee Gekregen	mee|krijgen	Gekregen	krijgen
mee genoomen	mee|nemen	genoomen	nemen
mee had	mede|hebben	had	hebben
mee heb	mede|hebben	heb	hebben
mee heeft	mede|hebben	heeft	hebben
mee moet	mee|moeten	moet	moeten
mee nam	mee|nemen	nam	nemen
mee neeme	mee|nemen	neeme	nemen
mee nemen	mee|nemen	nemen	nemen
mee spreeken	mee|spreken	spreeken	spreken
mee stiert	mee|sturen	stiert	sturen
mee verset	mee|verzetten	verset	verzetten
meij Brengen	mee|brengen	Brengen	brengen
merk aan	merken|aan	merk	merken
merke aan	merken|aan	merke	merken
merke aen	merken|aan	merke	merken
merken aan	merken|aan	merken	merken
mer senden	mee|zenden	senden	zenden
met geefen	mee|geven	geefen	geven
met genomen	mee|nemen	genomen	nemen
met gestuurt	mee|sturen	gestuurt	sturen
met kregen	mee|krijgen	kregen	krijgen
met kregh	mee|krijgen	kregh	krijgen
met nemen	mee|nemen	nemen	nemen
mijs gedeelt	mis|delen	gedeelt	delen
mijs geloopen	mis|lopen	geloopen	lopen
mijt genoemen	mee|nemen	genoemen	nemen
mis gaet	mis|gaan	gaet	gaan
moet mee	moeten|mee	moet	moeten
naa Gezeete	na|zitten	Gezeete	zitten
naa gezien	na|zien	gezien	zien
naa laaten	na|laten	laaten	laten
naa Laaten	na|laten	Laaten	laten
naa laat	na|laten	laat	laten
naam af	nemen|af	naam	nemen
naar gevolght	na|volgen	gevolght	volgen
na bedaght	na|bedenken	bedaght	bedenken
na behou	na|behouden	behou	behouden
nache set	nacht|zeggen	set	zeggen
nae bleef	na|blijven	bleef	blijven
nae gaen	na|gaan	gaen	gaan
nae gelaten	na|laten	gelaten	laten
nae gezonden	na|zenden	gezonden	zenden
nae kommen	na|komen	kommen	komen
nae Koomend	na|komen	Koomend	komen
nae koomen	na|komen	koomen	komen
nae laaten	na|laten	laaten	laten
nae laeten	na|laten	laeten	laten
nae laten	na|laten	laten	laten
naer comen	na|komen	comen	komen
naer gaelaten	na|laten	gaelaten	laten
naer laete	na|laten	laete	laten
naer laeten	na|laten	laeten	laten
naer laten	na|laten	laten	laten
naer telaten	na|laten	telaten	laten
na gaan	na|gaan	gaan	gaan
na gaat	na|gaan	gaat	gaan
na geplant	na|planten	geplant	planten
na laate	na|laten	laate	laten
na laaten	na|laten	laaten	laten
Na laaten	na|laten	laaten	laten
na laat	na|laten	laat	laten
na laeten	na|laten	laeten	laten
na late	na|laten	late	laten
na laten	na|laten	laten	laten
namen in	nemen|in	namen	nemen
na	na|lopen	na	lopen
narigt en	na|richten	en	richten
na senden	na|zenden	senden	zenden
na vraage	na|vragen	vraage	vragen
neder daelende	neder|dalen	daelende	dalen
neder gevelt	neer|vellen	gevelt	vellen
neder slaen	neer|slaan	slaen	slaan
neder werpen	neer|werpen	werpen	werpen
neem aan	nemen|aan	neem	nemen
neeme aen	nemen|aan	neeme	nemen
neeme deel	nemen|deel	neeme	nemen
neemende of	nemen|af	neemende	nemen
neeme op	nemen|op	neeme	nemen
neeme waar	nemen|waar	neeme	nemen
neempt aen	nemen|aan	neempt	nemen
neempt mede	nemen|mee	neempt	nemen
neempt toe	nemen|toe	neempt	nemen
neemt aen	nemen|aan	neemt	nemen
neemt af	nemen|af	neemt	nemen
neemt aff	nemen|af	neemt	nemen
neemt an	nemen|aan	neemt	nemen
neemt int	nemen|in	neemt	nemen
neemt mee	nemen|mee	neemt	nemen
neemt terug	nemen|terug	neemt	nemen
neemt waar	nemen|waar	neemt	nemen
neemt wech	nemen|weg	neemt	nemen
neemt weg	nemen|weg	neemt	nemen
neem waar	nemen|waar	neem	nemen
neer geleijt	neer|leggen	geleijt	leggen
neer geslaagen	neer|slaan	geslaagen	slaan
neer Kompt	neer|komen	Kompt	komen
neer slaen	neer|slaan	slaen	slaan
neer zetten	neer|zetten	zetten	zetten
neer Zinken	neer|zinken	Zinken	zinken
nemen aen	nemen|aan	nemen	nemen
nemen af	nemen|af	nemen	nemen
nemen met	nemen|mee	nemen	nemen
nemen toe	nemen|toe	nemen	nemen
nemen wech	nemen|weg	nemen	nemen
neme op	nemen|op	neme	nemen
nempt aff	nemen|af	nempt	nemen
nempt toe	nemen|toe	nempt	nemen
nempt waer	nemen|waar	nempt	nemen
nemt Aen	nemen|aan	nemt	nemen
nemt waer	nemen|waar	nemt	nemen
oepen geebroeken	open|breken	geebroeken	breken
oepen geedaen	open|doen	geedaen	doen
of betaelt	af|betalen	betaelt	betalen
of breekende	af|breken	breekende	breken
of breken	af|breken	breken	breken
of brengen	af|brengen	brengen	brengen
ofer reeden	over|rijden	reeden	rijden
ofer weenteren	over|winteren	weenteren	winteren
off geloepen	af|lopen	geloepen	lopen
off laaden	af|laden	laaden	laden
off wachten	af|wachten	wachten	wachten
of gaen	af|gaan	gaen	gaan
of geeue	af|geven	geeue	geven
of geschooten	af|schieten	geschooten	schieten
of geset	af|zetten	geset	zetten
of geslagen	af|slaan	geslagen	slaan
of gesne	af|snijden	gesne	snijden
of gesproken	af|spreken	gesproken	spreken
of ghegaen	af|gaan	ghegaen	gaan
of ghestorven	af|sterven	ghestorven	sterven
of hebrant	af|branden	hebrant	branden
of komt	af|komen	komt	komen
of koomen	af|komen	koomen	komen
of Leijde	af|leggen	Leijde	leggen
of loope	af|lopen	loope	lopen
of loopen	af|lopen	loopen	lopen
of lope	af|lopen	lope	lopen
of lopen	af|lopen	lopen	lopen
of neemen	af|nemen	neemen	nemen
of schette	af|schieten	schette	schieten
of sent	af|zien	sent	zien
of slaen	af|slaan	slaen	slaan
of vordre	af|vorderen	vordre	vorderen
of weesen	af|zijn	weesen	zijn
om armen	om|armen	armen	armen
om brenghe	om|brengen	brenghe	brengen
om commen	om|komen	commen	komen
ome	thuis|komen	ome	komen
om fangen	ont|vangen	fangen	vangen
om fingh	ont|vangen	fingh	vangen
om gaan	om|gaan	gaan	gaan
om gaat	om|gaan	gaat	gaan
om gadt	om|gaan	gadt	gaan
om gaen	om|gaan	gaen	gaan
om gaet	om|gaan	gaet	gaan
om gekoom	komen|om	om	komen
om gescuruen	om|zwerven	gescuruen	zwerven
om geslaagen	om|slaan	geslaagen	slaan
om gevallen	om|vallen	gevallen	vallen
om ghort	om|horen	ghort	horen
om helsen	om|helzen	helsen	helzen
om Helsen	om|helzen	Helsen	helzen
om helse	om|helzen	helse	helzen
om hels	om|helzen	hels	helzen
om helst	om|helzen	helst	helzen
om helzen	om|helzen	helzen	helzen
om hooren	om|horen	hooren	horen
om keken	om|kijken	keken	kijken
om komen	om|komen	komen	komen
Om koomen	weder|omkomen	koomen	omkomen
om loepen	om|lopen	loepen	lopen
omme gaet	om|gaan	gaet	gaan
om packen	om|pakken	packen	pakken
om setten	om|zetten	setten	zetten
om sijn	om|zien	sijn	zien
om staet	om|staan	staet	staan
om steckt	ont|steken	steckt	steken
om sukkeld	om|sukkelen	sukkeld	sukkelen
om sweven	om|zweven	sweven	zweven
omt singelt	om|singelen	singelt	singelen
omt slaghe	ont|slagen	slaghe	slagen
om var gevallen	omver|vallen	gevallen	vallen
om ver gewaayd	omver|waaien	ver	waaien
om vrochte	om|wrochten	vrochte	wrochten
om wende	om|wenden	wende	wenden
om wisselen	om|wisselen	wisselen	wisselen
om Zien	om|zien	Zien	zien
onder gaaet	onder|gaan	gaaet	gaan
onder gaan	onder|gaan	gaan	gaan
onder gaen	onder|gaan	gaen	gaan
onder houden	onder|houden	houden	houden
onder Neemen	onder|nemen	Neemen	nemen
onder Regten	onder|richten	Regten	richten
onder steunt	onder|steunen	steunt	steunen
onder vind	onder|vinden	vind	vinden
onder vonden	onder|vinden	vonden	vinden
onder vragen	onder|vragen	vragen	vragen
onder wesen	onder|wijzen	wesen	wijzen
ondt fangen	ont|vangen	fangen	vangen
on fangen	ont|vangen	fangen	vangen
on fange	ont|vangen	fange	vangen
on gat	om|gaan	gat	gaan
ont bieden	ont|bieden	bieden	bieden
ont bloot	ont|bloten	bloot	bloten
ont boden	ont|bieden	boden	bieden
ont eboden	ont|bieden	eboden	bieden
ont fangen	ont|vangen	fangen	vangen
ont fange	ont|vangen	fange	vangen
ont fanghen	ont|vangen	fanghen	vangen
ont ffangen	ont|vangen	ffangen	vangen
ontf n	ont|vangen	n	vangen
ont last	ont|lasten	last	lasten
ont moeten	ont|moeten	moeten	moeten
ont moet	ont|moeten	moet	moeten
ont namen	ont|nemen	namen	nemen
ont singelt	om|singelen	singelt	singelen
ont slaan	ont|slaan	slaan	slaan
ont stelde	ont|stellen	stelde	stellen
ont vangen	ont|vangen	vangen	vangen
ont vange	ont|vangen	vange	vangen
ont vanghen	ont|vangen	vanghen	vangen
ontwaar worden	ontwaar|worden	worden	worden
oon faengen	ont|vangen	faengen	vangen
oopen dee	open|doen	dee	doen
oopen gesneede	open|snijden	gesneede	snijden
oouer hebbe	over|hebben	hebbe	hebben
oover gaen	over|gaan	gaen	gaan
oover geschoote	over|schieten	geschoote	schieten
oover handigen	over|handigen	handigen	handigen
oover lede	over|lijden	lede	lijden
oover leeden	over|lijden	leeden	lijden
oover macken	over|maken	macken	maken
oovers ziet	over|schieten	ziet	schieten
op bijnde	op|binden	bijnde	binden
op blase	op|blazen	blase	blazen
op brengen	op|brengen	brengen	brengen
op brengt	op|brengen	brengt	brengen
op brocht	op|brengen	brocht	brengen
op comt	op|komen	comt	komen
op dagen	op|dagen	dagen	dagen
op dragende	op|dragen	dragende	dragen
op eeten	op|eten	eeten	eten
op eijssen	op|eisen	eijssen	eisen
open doen	open|doen	doen	doen
open gebroeken	open|breken	gebroeken	breken
open gedaan	open|doen	gedaan	doen
open gedaen	open|doen	gedaen	doen
open gegaan	open|gaan	gegaan	gaan
open houue	open|houden	houue	houden
op gaan	op|gaan	gaan	gaan
op gebracht	op|brengen	gebracht	brengen
op Gebragt	op|brengen	Gebragt	brengen
op gebrocht	op|brengen	gebrocht	brengen
op gebroecken	op|breken	gebroecken	breken
op gebroght	op|brengen	gebroght	brengen
op gecommen	op|komen	gecommen	komen
op gedaan	op|doen	gedaan	doen
op geeijst	op|eisen	geeijst	eisen
op geeven	op|geven	geeven	geven
op gehangen	op|hangen	gehangen	hangen
op geheven	op|heffen	geheven	heffen
op ge kome	op|komen	kome	komen
op gelegt	op|leggen	gelegt	leggen
op geleijt	op|leggen	geleijt	leggen
op geloopen	op|lopen	geloopen	lopen
op gemaakt	op|maken	gemaakt	maken
op gemerk	op|merken	gemerk	merken
op genomen	op|nemen	genomen	nemen
op geoffert	op|offeren	geoffert	offeren
op gepropt	op|proppen	gepropt	proppen
op geqveckt	op|kweken	geqveckt	kweken
op geset	op|zetten	geset	zetten
op ge sloote	op|sluiten	sloote	sluiten
op gestaen	op|staan	gestaen	staan
op getrocken	op|trekken	getrocken	trekken
op geuen	op|geven	geuen	geven
op geven	op|geven	geven	geven
op gevulde	op|vullen	gevulde	vullen
op gevuldt	op|vullen	gevuldt	vullen
op ghehaelt	op|halen	ghehaelt	halen
op ghehanghen	op|hangen	ghehanghen	hangen
op ghetrocken	op|trekken	ghetrocken	trekken
op gheven	op|geven	gheven	geven
op Ging	op|gaan	Ging	gaan
Op haele	op|halen	haele	halen
op halen	op|halen	halen	halen
op hallen	op|halen	hallen	halen
op hauden	op|houden	hauden	houden
op hebben	op|hebben	hebben	hebben
op heffen	op|heffen	heffen	heffen
op houden	op|houden	houden	houden
op houd	op|houden	houd	houden
op hout	op|houden	hout	houden
op houwen	op|houden	houwen	houden
op houwe	op|houden	houwe	houden
op kloppe	op|kloppen	kloppe	kloppen
op komen	op|komen	komen	komen
op kome	op|komen	kome	komen
op koomen	op|komen	koomen	komen
op koome	op|komen	koome	komen
op leeve	op|leven	leeve	leven
op let	op|letten	let	letten
op letten	op|letten	letten	letten
op loopen	op|lopen	loopen	lopen
op maaken	op|maken	maaken	maken
op maakt	op|maken	maakt	maken
op maken	op|maken	maken	maken
op make	op|maken	make	maken
op merken	op|merken	merken	merken
op neemen	op|nemen	neemen	nemen
op neeme	op|nemen	neeme	nemen
op nemen	op|nemen	nemen	nemen
op Nieuws	op|nieuw	Nieuws	nieuw
op offeren	op|offeren	offeren	offeren
op ontboden	op|ontbieden	ontboden	ontbieden
op	op|houden	op	houden
op passen	op|passen	passen	passen
op passe	op|passen	passe	passen
op past	op|passen	past	passen
op queeken	op|kweken	queeken	kweken
op schryven	op|schrijven	schryven	schrijven
op setten	op|zetten	setten	zetten
op slocken	op|slokken	slocken	slokken
op sloog	op|slaan	sloog	slaan
op soecken	op|zoeken	soecken	zoeken
op soike	op|zoeken	soike	zoeken
op spueren	op|speuren	spueren	speuren
op staen	op|staan	staen	staan
op steeken	op|steken	steeken	steken
op stellen	op|stellen	stellen	stellen
op teijckenen	op|tekenen	teijckenen	tekenen
op trecken	op|trekken	trecken	trekken
op trekken	op|trekken	trekken	trekken
op Trekken	op|trekken	Trekken	trekken
op Trokken	op|trekken	Trokken	trekken
op uoeren	op|voeren	uoeren	voeren
op vaeren	op|varen	vaeren	varen
op varende	op|varen	varende	varen
op vissen	op|vissen	vissen	vissen
op viste	op|vissen	viste	vissen
op voede	op|voeden	voede	voeden
op volgen	op|volgen	volgen	volgen
op Volgen	op|volgen	Volgen	volgen
Op Volgen	op|volgen	Volgen	volgen
op vollen	op|vullen	vollen	vullen
op vulle	op|vullen	vulle	vullen
op waschen	op|wassen	waschen	wassen
op wassen	op|wassen	wassen	wassen
op wasse	op|wassen	wasse	wassen
op wecken	op|wekken	wecken	wekken
op zegghe	op|zeggen	zegghe	zeggen
op zend	op|zenden	zend	zenden
ouer bleef	over|blijven	bleef	blijven
ouer blijft	over|blijven	blijft	blijven
ouer gebleuen	over|blijven	gebleuen	blijven
ouer gecomen	over|komen	gecomen	komen
ouer geeue	over|geven	geeue	geven
ouer gegeuen	over|geven	gegeuen	geven
ouer gegeue	over|geven	gegeue	geven
ouer gehouden	over|houden	gehouden	houden
ouer geschooten	over|schieten	geschooten	schieten
ouer geuen	over|geven	geuen	geven
ouer hebben	over|hebben	hebben	hebben
ouer heb	over|hebben	heb	hebben
ouer komen	over|komen	komen	komen
ouer leden	over|lijden	leden	lijden
ouer leeft	over|leven	leeft	leven
ouer left	over|leven	left	leven
ouer schieten	over|schieten	schieten	schieten
ouer senden	over|zenden	senden	zenden
ouer stueren	over|sturen	stueren	sturen
ouer vallen	over|vallen	vallen	vallen
oveer leden	over|lijden	leden	lijden
over betaelt	over|betalen	betaelt	betalen
over blyven	over|blijven	blyven	blijven
over brengen	over|brengen	brengen	brengen
over comen	over|komen	comen	komen
over Comen	over|komen	Comen	komen
over doen	over|doen	doen	doen
over een komen	overeen|komen	komen	komen
over een komme	overeen|komen	komme	komen
over een koomen	overeen|komen	koomen	komen
overeen stemmen	overeen|stemmen	stemmen	stemmen
over gaan	over|gaan	gaan	gaan
over gebleven	over|blijven	gebleven	blijven
over gebracht	over|brengen	gebracht	brengen
over gecomen	over|komen	gecomen	komen
over geeven	over|geven	geeven	geven
over ge gaan	over|gaan	gaan	gaan
over ge gaen	over|gaan	gaen	gaan
over gegaen	over|gaan	gegaen	gaan
over gehouden	over|houden	gehouden	houden
over gekomen	over|komen	gekomen	komen
over gekonen	over|komen	gekonen	komen
over Gelden	over|gelden	Gelden	gelden
over geleeft	over|leven	geleeft	leven
over geleijt	over|leggen	geleijt	leggen
over gesonden	over|zenden	gesonden	zenden
over gestuurt	over|sturen	gestuurt	sturen
over getransporttert	over|transporteren	getransporttert	transporteren
over gevaaren	over|varen	gevaaren	varen
over gevaren	over|varen	gevaren	varen
over geven	over|geven	geven	geven
over gewerkt	over|werken	gewerkt	werken
over geworpen	over|werpen	geworpen	werpen
over gezeijlt	over|zeilen	gezeijlt	zeilen
over ghebleven	over|blijven	ghebleven	blijven
over ghekreeghen	over|krijgen	ghekreeghen	krijgen
over ginck	over|gaan	ginck	gaan
over ging	over|gaan	ging	gaan
Over haalen	over|halen	haalen	halen
over haat	over|hebben	haat	hebben
over handig	over|handigen	handig	handigen
over heb	over|hebben	heb	hebben
over hebt	over|hebben	hebt	hebben
over heeft	over|hebben	heeft	hebben
over heelp	over|helpen	heelp	helpen
over hellen	over|hellen	hellen	hellen
over houden	over|houden	houden	houden
over komen	over|komen	komen	komen
over kome	over|komen	kome	komen
over komt	over|komen	komt	komen
over koomen	over|komen	koomen	komen
Over Koomen	over|komen	Koomen	komen
over koomt	over|komen	koomt	komen
over leden	over|lijden	leden	lijden
over lede	over|lijden	lede	lijden
over leeden	over|lijden	leeden	lijden
over leeven	over|leven	leeven	leven
over leeveren	over|leveren	leeveren	leveren
over leevert	over|leveren	leevert	leveren
over legge	over|leggen	legge	leggen
over leven	over|leven	leven	leven
over leveren	over|leveren	leveren	leveren
over leyd	over|leiden	leyd	leiden
over maeckt	over|maken	maeckt	maken
over maken	over|maken	maken	maken
over neemen	over|nemen	neemen	nemen
over nemen	over|nemen	nemen	nemen
over reekenen	over|rekenen	reekenen	rekenen
over schieden	over|schieten	schieden	schieten
over schieten	over|schieten	schieten	schieten
over schiete	over|schieten	schiete	schieten
over schijeten	over|schieten	schijeten	schieten
over schrijven	over|schrijven	schrijven	schrijven
over senden	over|zenden	senden	zenden
over sende	over|zenden	sende	zenden
over setten	over|zetten	setten	zetten
over sien	over|zien	sien	zien
over sparen	over|sparen	sparen	sparen
over Stappen	over|stappen	Stappen	stappen
over steuren	over|sturen	steuren	sturen
over stieren	over|sturen	stieren	sturen
over stier	over|sturen	stier	sturen
over stieuren	over|sturen	stieuren	sturen
over stuijren	over|sturen	stuijren	sturen
over sturen	over|sturen	sturen	sturen
over sturt	over|sturen	sturt	sturen
over stuuren	over|sturen	stuuren	sturen
over uame	over|vamen	uame	vamen
over vallen	over|vallen	vallen	vallen
over Zeijld	over|zeilen	Zeijld	zeilen
over Zenden	over|zenden	Zenden	zenden
over zende	over|zenden	zende	zenden
ower leeft	over|leven	leeft	leven
ower Legen	over|leggen	Legen	leggen
ower senden	over|zenden	senden	zenden
ower sende	over|zenden	sende	zenden
pas hop	passen|op	pas	passen
pas op	passen|op	pas	passen
paste op	passen|op	paste	passen
past op	passen|op	past	passen
Past op	passen|op	Past	passen
plaats gehad	plaats|hebben	gehad	hebben
Plaats gehad	plaats|hebben	gehad	hebben
Plaats Gehad	plaats|hebben	Gehad	hebben
Plaats gevonden	plaats|vinden	gevonden	vinden
Plaats hadde	plaats|hebben	hadde	hebben
plaats hadt	plaats|hebben	hadt	hebben
plaats hebbe	plaats|hebben	hebbe	hebben
plaats vinden	plaats|vinden	vinden	vinden
preis macken	prijs|maken	macken	maken
prijse aan	prijzen|aan	prijse	prijzen
quaad spreeken	kwaad|spreken	spreeken	spreken
quaijt geraeckt	kwijt|raken	geraeckt	raken
quam aen	aan|komen	aen	komen
quam by	bij|komen	by	komen
quame tuijs	komen|thuis	quame	komen
quam op	komen|op	quam	komen
quam over	komen|over	quam	komen
quam weer	komen|weer	quam	komen
Quam weer	komen|weer	Quam	komen
quijet raeken	kwijt|raken	raeken	raken
Quijt geraecken	kwijt|raken	geraecken	raken
quijt geraken	kwijt|raken	geraken	raken
quijt raken	kwijt|raken	raken	raken
quit geraeckt	kwijt|raken	geraeckt	raken
quit racken	kwijt|raken	racken	raken
quit raken	kwijt|raken	raken	raken
raakt kwijt	raken|kwijt	raakt	raken
raakt vol	raken|vol	raakt	raken
rackt op	raken|op	rackt	raken
recht veerdijgen	recht|vaardigen	veerdijgen	vaardigen
rockenen op	rokkenen|op	rockenen	rokkenen
roepen toe	roepen|toe	roepen	roepen
roept aen	roepen|aan	roept	roepen
roept aend	roepen|aan	roept	roepen
roept uit	roepen|uit	roept	roepen
rond drijven	rond|drijven	drijven	drijven
rond gaan	rond|gaan	gaan	gaan
rond spoelen	rond|spoelen	spoelen	spoelen
ruckt te samen	rukken|samen	ruckt	rukken
ruept an	roepen|aan	ruept	roepen
rytug koome	terug|komen	koome	komen
sag uijt	zien|uit	sag	zien
samen gevoeght	samen|voegen	gevoeght	voegen
samen voegen	samen|voegen	voegen	voegen
scheijde aff	scheiden|af	scheijde	scheiden
schiet te kort	schieten|tekort	schiet	schieten
schone make	schoon|maken	make	maken
schon maken	schoon|maken	maken	maken
school gaan	school|gaan	gaan	gaan
schoon gemaekt	schoon|maken	gemaekt	maken
schoon maecken	schoon|maken	maecken	maken
schoon maeckten	schoon|maken	maeckten	maken
schreve wederom	omschrijven|weder	schreve	omschrijven
Schreyve af	schrijven|af	Schreyve	schrijven
schrieft weder om	omschrijven|weder	schrieft	omschrijven
schrift weder om	omschrijven|weder	schrift	omschrijven
schrift wederom	omschrijven|weder	schrift	omschrijven
schrijeft weeder	schrijven|weder	schrijeft	schrijven
schrijeft wer	schrijven|weder	schrijeft	schrijven
schrijf af	schrijven|af	schrijf	schrijven
Schrijft wederomme	omschrijven|weder	Schrijft	omschrijven
schrijft wederom	omschrijven|weder	schrijft	omschrijven
schrijft weer	schrijven|we(d)er	schrijft	schrijven
schrijven wederom	omschrijven|weder	schrijven	omschrijven
schrijve toe	schrijven|toe	schrijve	schrijven
schryeft wederom	omschrijven|weder	schryeft	omschrijven
Schryft weerom	schrijven|weerom	Schryft	schrijven
schynt toe	schijnen|toe	schynt	schijnen
sckiet over	schieten|over	sckiet	schieten
scolden uijt	schelden|uit	scolden	schelden
screijft tu	schrijven|toe	screijft	schrijven
scryeft verom	schrijven|weerom	scryeft	schrijven
secht aen	zeggen|aan	secht	zeggen
secht goede nachten	nacht|goede|zeggen	nachten	zeggen
secht goeden nacht	zeggen|goede|nacht	secht	zeggen
secht goeden Nacht	zeggen|goede|nacht	secht	zeggen
secht goenacht	zeggen|goede|nacht	secht	zeggen
seecht genaecht	zeggen|genacht	seecht	zeggen
seegt goedenach	zeggen|goede|nacht	seegt	zeggen
segen	goede|nacht|zeggen	segen	zeggen
segge	goede|nacht|zeggen	segge	zeggen
seg genach	zeggen|genacht	seg	zeggen
seggen	goede|nacht|zeggen	seggen	zeggen
seggen goeden	zeggen|goede|nacht	seggen	zeggen
seghdt	zeggen|goede|nacht	seghdt	zeggen
seghe ghenacht	zeggen|genacht	seghe	zeggen
segh genach	zeggen|genacht	segh	zeggen
segh genacht	zeggen|genacht	segh	zeggen
segh goede nacht	zeggen|goede|nacht	segh	zeggen
seght genacht	zeggen|genacht	seght	zeggen
seght genaght	zeggen|genacht	seght	zeggen
seght ghenagh	zeggen|genacht	seght	zeggen
seght goede nachten	zeggen|goede|nacht	seght	zeggen
seght	goede|zeggen|nacht	seght	zeggen
seght goede naght	zeggen|goede|nacht	seght	zeggen
seght tee	zeggen|toe	seght	zeggen
segt	goede|zeggen|nacht	segt	zeggen
segt goeden nacht	zeggen|goede|nacht	segt	zeggen
seijdt genacht	zeggen|genacht	seijdt	zeggen
sende toe	zenden|toe	sende	zenden
Sende weder	zenden|weder	Sende	zenden
sent toe	zenden|toe	sent	zenden
sent	zenden|toe	sent	zenden
sette bij	zetten|bij	sette	zetten
set ter ujt	zien|er|uit	set	zien
siedt toe	zien|toe	siedt	zien
Sien	achter|uitzien	Sien	uitzien
sien an	zien|aan	sien	zien
sien daar uyt	zien|er|uit	sien	zien
sien	weder|omzien	sien	omzien
siet aen	zien|aan	siet	zien
sie tegemoet	zien|tegemoet	sie	zien
siet foor	zien|voor	siet	zien
siet om	zien|om	siet	zien
siet toe	zien|toe	siet	zien
siet uyt	zien|uit	siet	zien
siet vor	zien|voor	siet	zien
sijet toe	zien|toe	sijet	zien
sijet uijt	zien|uit	sijet	zien
sijet vijt	zien|uit	sijet	zien
sijn om	zien|om	sijn	zien
sitten vast	zitten|vast	sitten	zitten
slaan op	slaan|op	slaan	slaan
slaat over	slaan|over	slaat	slaan
slaa weg	slaan|weg	slaa	slaan
slaet af	slaan|af	slaet	slaan
smelt Weg	smelten|weg	smelt	smelten
smijte wyt	smijten|uit	smijte	smijten
smijt toe	smijten|toe	smijt	smijten
soek geraakt	zoek|raken	geraakt	raken
speel vaare	spele|varen	vaare	varen
spoelde weg	spoelen|weg	spoelde	spoelen
spoelende rond	spoelen|rond	spoelende	spoelen
sprak aan	spreken|aan	sprak	spreken
spreck aen	spreken|aan	spreck	spreken
spreek aan	spreken|aan	spreek	spreken
Spreekt tegen	spreken|tegen	Spreekt	spreken
sreijft wer om	schrijven|weerom	sreijft	schrijven
staad still	staan|stil	staad	staan
staat aan	staan|aan	staat	staan
Staat aan	staan|aan	Staat	staan
staat Leedig	staan|leeg	staat	staan
staat stil	staan|stil	staat	staan
staecken op	steken|op	staecken	steken
staen an	staan|aan	staen	staan
staen stijl	staan|stil	staen	staan
staen toe	staan|toe	staen	staan
staet aan	staan|aan	staet	staan
staet aen	staan|aan	staet	staan
staet om	staan|om	staet	staan
staet op	staan|op	staet	staan
staet stijel	staan|stil	staet	staan
staet stijl	staan|stil	staet	staan
staet tegen	staan|tegen	staet	staan
staet uijt	staan|uit	staet	staan
stan stijel	staan|stil	stan	staan
stappe af	stappen|af	stappe	stappen
stat aen	staan|aan	stat	staan
stat op	staan|op	stat	staan
stat vast	staan|vast	stat	staan
steld bloot	stellen|bloot	steld	stellen
stelden te weer	stellen|teweer	stelden	stellen
Steld gerüst	stellen|gerust	Steld	stellen
stelle geseten	stil|zitten	geseten	zitten
stellen te vreeden	stellen|tevreden	stellen	stellen
stelt op	stellen|op	stelt	stellen
stel uit	stellen|uit	stel	stellen
ster over	sturen|over	ster	sturen
steruen wech	sterven|weg	steruen	sterven
sterven uyt	sterven|uit	sterven	sterven
stiel sietten	stil|zitten	sietten	zitten
stieren	thuis|sturen	stieren	sturen
stijere mete	sturen|mee	stijere	sturen
stijert ouer	sturen|over	stijert	sturen
stijert tuijs	sturen|thuis	stijert	sturen
stil gehoude	stil|houden	gehoude	houden
stil gestaen	stil|staan	gestaen	staan
stil houden	stil|houden	houden	houden
stil houde	stil|houden	houde	houden
stil staen	stil|staan	staen	staan
stil staet	stil|staan	staet	staan
stil stan	stil|staan	stan	staan
strekt uit	strekken|uit	strekt	strekken
stuerden weerom	sturen|weerom	stuerden	sturen
stueren aur	sturen|over	stueren	sturen
stuere over	sturen|over	stuere	sturen
Stuer mee	sturen|mee	Stuer	sturen
stuert weeder	sturen|weder	stuert	sturen
stuijerdt oouer	sturen|over	stuijerdt	sturen
stur an	sturen|aan	stur	sturen
stur over	sturen|over	stur	sturen
Stuurde uyt	sturen|uit	Stuurde	sturen
swjcht stjl	zwijgen|stil	swjcht	zwijgen
swyg stil	zwijgen|stil	swyg	zwijgen
te coert coomen	tekort|komen	coomen	komen
te cort comen	tekort|komen	comen	komen
tecort comen	tekort|komen	comen	komen
te cort doen	tekort|doen	doen	doen
te Cort doen	tekort|doen	doen	doen
Teegen geloopen	tegen|lopen	geloopen	lopen
teeg en loop	tegen|lopen	en	lopen
teegen loopt	tegen|lopen	loopt	lopen
teerdt	achter|uitteren	teerdt	uitteren
tegemoet komen	tegemoet|komen	komen	komen
tegemoet koomen	tegemoet|komen	koomen	komen
tegemoet sien	tegemoet|zien	sien	zien
tegemoet zien	tegemoet|zien	zien	zien
tegen gaan	tegen|gaan	gaan	gaan
tegen geloopen	tegen|lopen	geloopen	lopen
tegen krijgen	tegen|krijgen	krijgen	krijgen
tegen stan	tegen|staan	stan	staan
tegen werken	tegen|werken	werken	werken
te Heus Kom	thuis|komen	Kom	komen
te hiys vaaren	thuis|varen	vaaren	varen
te huijs blijft	thuis|blijven	blijft	blijven
te huijs brengen	thuis|brengen	brengen	brengen
te huijs comen	thuis|komen	comen	komen
te huijs comt	thuis|komen	comt	komen
te huijs gebragt	thuis|brengen	te	brengen
te huijs gekoomen	thuis|komen	gekoomen	komen
tehuijs gelaaten	thuis|laten	gelaaten	laten
te huijs gevaaren	thuis|varen	gevaaren	varen
te huijs komen	thuis|komen	komen	komen
te huijs komt	thuis|komen	komt	komen
tehuijs komt	thuis|komen	komt	komen
te huijs Komt	thuis|komen	Komt	komen
te huijs koomende	thuis|komen	koomende	komen
te huijs koomen	thuis|komen	koomen	komen
te huijs quant	thuis|komen	te	komen
te huijs	sturen|thuis	te	sturen
te huis coomend	thuis|komen	coomend	komen
te huis gekomen	thuis|komen	gekomen	komen
te Huis komen	thuis|komen	komen	komen
te huis koomen	thuis|komen	koomen	komen
te huis koome	thuis|komen	koome	komen
te huis koomt	thuis|komen	koomt	komen
te huis kwam	thuis|komen	te	komen
tehus komen	thuis|komen	komen	komen
te hus kommen	thuis|komen	kommen	komen
te huys gebragt	thuis|brengen	te	brengen
te huys gecomen	thuis|komen	gecomen	komen
tehuys gecoomen	thuis|komen	gecoomen	komen
Tehuys kome	thuis|komen	kome	komen
Tehuys Komt	thuis|komen	Komt	komen
te huys	komen|thuis	te	komen
te kordt doen	tekort|doen	doen	doen
tekordt komdt	tekort|komen	komdt	komen
te kort doen	tekort|doen	doen	doen
te kort gedaan	tekort|doen	te	doen
te kort komen	tekort|komen	komen	komen
te kort komt	tekort|komen	komt	komen
te kort koomen	tekort|komen	koomen	komen
te Kort quam	tekort|komen	Kort	komen
ten huijs comen	thuis|komen	comen	komen
te niet doen	teniet|doen	doen	doen
te Niet loopen	teniet|lopen	loopen	lopen
te reche helpe	terecht|helpen	helpe	helpen
te rech helpe	terecht|helpen	helpe	helpen
te rechte comen	terecht|komen	comen	komen
terechte Comen	terecht|komen	Comen	komen
te rechte helpe	terecht|helpen	helpe	helpen
te rechte komen	terecht|komen	komen	komen
te rechten brengen	terecht|brengen	brengen	brengen
te Rechten quamen	terecht|komen	quamen	komen
te rechte raecke	terecht|raken	raecke	raken
te recht gekomen	terecht|komen	gekomen	komen
te recht ghekomen	terecht|komen	ghekomen	komen
te recht helpen	terecht|helpen	helpen	helpen
te recht komen	terecht|komen	komen	komen
te recht quaemt	terecht|komen	te	komen
te recht quam	terecht|komen	te	komen
te Recht quam	terecht|komen	te	komen
te reght gekoomen	terecht|komen	gekoomen	komen
te reght helpen	terecht|helpen	helpen	helpen
te reght kome	terecht|komen	kome	komen
te regte komen	terecht|komen	komen	komen
te regt gekoomen	terecht|komen	gekoomen	komen
te regt Gekoomen	terecht|komen	Gekoomen	komen
te regt gekoome	terecht|komen	te	komen
te regt komen	terecht|komen	komen	komen
Te regt komt	terecht|komen	komt	komen
te regt koomen	terecht|komen	koomen	komen
te regt koome	terecht|komen	koome	komen
te regt koomt	terecht|komen	koomt	komen
ter neer geslaagen	terneer|slaan	geslaagen	slaan
ter Toone stellen	tentoon|stellen	stellen	stellen
te rug gaat	terug|gaan	gaat	gaan
te ruggedrijven	terug|drijven	ruggedrijven	drijven
terug gehouden	terug|houden	gehouden	houden
te rug gekoomen	terug|komen	gekoomen	komen
te rüg gesonden	terug|zenden	gesonden	zenden
te rug haalen	terug|halen	haalen	halen
te rugh drijue	terug|drijven	drijue	drijven
te rugh gehouden	terug|houden	gehouden	houden
terug keeren	terug|keren	keeren	keren
te Rug keer	terug|keren	keer	keren
te rug komen	terug|komen	komen	komen
te rug koomen	terug|komen	koomen	komen
te rug leggen	terug|liggen	leggen	liggen
te rug zenden	terug|zenden	zenden	zenden
ter weegh brengen	teweeg|brengen	brengen	brengen
teuijs komen	thuis|komen	komen	komen
teuijs koomen	thuis|komen	koomen	komen
teureden stellen	tevreden|stellen	stellen	stellen
te	voort|komen	te	komen
te vreden stellen	tevreden|stellen	stellen	stellen
te vreeden Stellen	tevreden|stellen	Stellen	stellen
te vreede stellen	tevreden|stellen	stellen	stellen
te wechge gebrocht	teweeg|brengen	wechge	brengen
te weege bringen	teweeg|brengen	bringen	brengen
te weeg gebragt	teweeg|brengen	weeg	brengen
te weghe brengen	teweeg|brengen	brengen	brengen
te weghe brenghen	teweeg|brengen	brenghen	brengen
te wereden stelen	tevreden|stellen	stelen	stellen
te zaamen gezet	tezamen|zetten	zaamen	zetten
te zaamen woonen	tezamen|wonen	woonen	wonen
thijus ghekomen	thuis|komen	ghekomen	komen
thijus kome	thuis|komen	kome	komen
thues haelen	thuis|halen	haelen	halen
thuess gekamen	thuis|komen	gekamen	komen
thuijs breijngen	thuis|brengen	breijngen	brengen
thuijs brengen	thuis|brengen	brengen	brengen
thuijs brenghen	thuis|brengen	brenghen	brengen
thuijs Brenghen	thuis|brengen	Brenghen	brengen
thuijs comende	thuis|komen	comende	komen
t huijs comen	thuis|komen	comen	komen
thuijs comen	thuis|komen	comen	komen
thuijs come	thuis|komen	come	komen
t’huijs coomen	thuis|komen	coomen	komen
thuijs coomen	thuis|komen	coomen	komen
thuijs Coomen	thuis|komen	Coomen	komen
thuijs gecomen	thuis|komen	gecomen	komen
thuijs gecoomen	thuis|komen	gecoomen	komen
t huijs gekomen	thuis|komen	gekomen	komen
thuijs gekomen	thuis|komen	gekomen	komen
thuijs gestuurt	thuis|sturen	gestuurt	sturen
thuijs halen	thuis|halen	halen	halen
t’huijs hoorden	thuis|horen	hoorden	horen
thuijs hoorende	thuis|horen	hoorende	horen
t'huijs komen	thuis|komen	komen	komen
t’huijs komen	thuis|komen	komen	komen
thuijs komen	thuis|komen	komen	komen
thuijs kompt	thuis|komen	kompt	komen
thuijs komt	thuis|komen	komt	komen
thuijs quam	thuis|komen	quam	komen
thuis brengen	thuis|brengen	brengen	brengen
thuis come	thuis|komen	come	komen
thuis gecomen	thuis|komen	gecomen	komen
thuis gekomen	thuis|komen	gekomen	komen
thuis haelle	thuis|halen	haelle	halen
thuis houden	thuis|houden	houden	houden
thus comen	thuis|komen	comen	komen
thus komen	thuis|komen	komen	komen
thus koomen	thuis|komen	koomen	komen
thuus quam	thuis|komen	quam	komen
thuuys koomen	thuis|komen	koomen	komen
thuys Coomen	thuis|komen	Coomen	komen
thuys gebleven	thuis|blijven	gebleven	blijven
thuys gekoome	thuis|komen	gekoome	komen
t huys gekreeg	thuis|krijgen	gekreeg	krijgen
thuys gelatten	thuis|laten	gelatten	laten
Thuys halen	thuis|halen	halen	halen
thuys komende	thuis|komen	komende	komen
thuys kom	thuis|komen	kom	komen
thuys koomende	thuis|komen	koomende	komen
thuys quaem	thuis|komen	quaem	komen
tius ghecom	thuis|komen	ghecom	komen
toe be hoort	toe|behoren	toe	behoren
toe bid	toe|bidden	bid	bidden
toe brengen	toe|brengen	brengen	brengen
toe brenge	toe|brengen	brenge	brengen
toe comen	toe|komen	comen	komen
toe comt	toe|komen	comt	komen
toe coomen	toe|komen	coomen	komen
toe draagen	toe|dragen	draagen	dragen
toe draecht	toe|dragen	draecht	dragen
toe draeght	toe|dragen	draeght	dragen
toe gaet	toe|gaan	gaet	gaan
Toe gebragt	toe|brengen	gebragt	brengen
toe gecoome	toe|komen	gecoome	komen
toe gedragen	toe|dragen	gedragen	dragen
toe gedrage	toe|dragen	gedrage	dragen
toe gereeckent	toe|rekenen	gereeckent	rekenen
toe geschikt	toe|schikken	geschikt	schikken
toe geslagen	toe|slaan	geslagen	slaan
toe ge sloeten	toe|sluiten	sloeten	sluiten
toe gesonden	toe|zenden	gesonden	zenden
Toe gesonden	toe|zenden	gesonden	zenden
toe gesonde	toe|zenden	gesonde	zenden
toe gevalle	toe|vallen	gevalle	vallen
toe gevoegd	toe|voegen	gevoegd	voegen
toe gevroren	toe|vriezen	gevroren	vriezen
toe gewenscht	toe|wensen	gewenscht	wensen
toe gewens	toe|wensen	gewens	wensen
toe gewenst	toe|wensen	gewenst	wensen
toe komen	toe|komen	komen	komen
toe kommen	toe|komen	kommen	komen
toe komt	toe|komen	komt	komen
toe laat	toe|laten	laat	laten
toe laet	toe|laten	laet	laten
toe late	toe|laten	late	laten
toe lyt	toe|laten	lyt	laten
toe maken	toe|maken	maken	maken
toe nam	toe|nemen	nam	nemen
toe neemen	toe|nemen	neemen	nemen
toe nemen	toe|nemen	nemen	nemen
toe niet gedaen	teniet|doen	toe	doen
toe packen	toe|pakken	packen	pakken
toe quam	toe|komen	quam	komen
toe qvam	toe|komen	qvam	komen
toe schicken	toe|schikken	schicken	schikken
toe schrijven	toe|schrijven	schrijven	schrijven
toe screijven	toe|schrijven	screijven	schrijven
toe seijnden	toe|zenden	seijnden	zenden
toe senden	toe|zenden	senden	zenden
toe sende	toe|zenden	sende	zenden
Toe sende	toe|zenden	sende	zenden
toe send	toe|zenden	send	zenden
toe sien	toe|zien	sien	zien
toe sijn de	toe|zenden	de	zenden
toe sluijtten	toe|sluiten	sluijtten	sluiten
toe spreecken	toe|spreken	spreecken	spreken
Toe springen	toe|springen	springen	springen
toe Stemmen	toe|stemmen	Stemmen	stemmen
toe stiere	toe|sturen	stiere	sturen
toe stont	toe|staan	stont	staan
toe stueren	toe|sturen	stueren	sturen
toeuw gesloeten	toe|sluiten	gesloeten	sluiten
toe vertouwe	toe|vertrouwen	vertouwe	vertrouwen
toe vertrouwen	toe|vertrouwen	vertrouwen	vertrouwen
toe vil	toe|vallen	vil	vallen
toe voegen	toe|voegen	voegen	voegen
toe wenschende	toe|wensen	wenschende	wensen
toe wenschen	toe|wensen	wenschen	wensen
toe wensche	toe|wensen	wensche	wensen
Toe Wensche	toe|wensen	Wensche	wensen
toe wenscht	toe|wensen	wenscht	wensen
toe wensende	toe|wensen	wensende	wensen
toe wensend	toe|wensen	wensend	wensen
toe wensen	toe|wensen	wensen	wensen
toe wenste	toe|wensen	wenste	wensen
toe zenden	toe|zenden	zenden	zenden
toe Zenden	toe|zenden	Zenden	zenden
toe zende	toe|zenden	zende	zenden
tois kome	thuis|komen	kome	komen
toi wens	toe|wensen	wens	wensen
to pasen	toe|passen	pasen	passen
tot schrijwen	toe|schrijven	schrijwen	schrijven
treckt aen	trekken|aan	treckt	trekken
trek op	trekken|op	trek	trekken
Trekt aff	trekken|af	Trekt	trekken
tu compt	toe|komen	compt	komen
tueijs comen	thuis|komen	comen	komen
tues comen	thuis|komen	comen	komen
tues stijeren	thuis|sturen	stijeren	sturen
tuhijs gecomen	thuis|komen	gecomen	komen
tuhijs kome	thuis|komen	kome	komen
tuij coeme	thuis|komen	coeme	komen
tuijs aellen	thuis|halen	aellen	halen
tuijs comen	thuis|komen	comen	komen
tuijs come	thuis|komen	come	komen
tuijs compt	thuis|komen	compt	komen
tuijs comt	thuis|komen	comt	komen
tuijs Comt	thuis|komen	Comt	komen
tuijs con	thuis|komen	con	komen
tuijs coomen	thuis|komen	coomen	komen
tuijs gebracht	thuis|brengen	gebracht	brengen
tuijs gecomen	thuis|komen	gecomen	komen
tuijs gecoommen	thuis|komen	gecoommen	komen
tuijs gekomen	thuis|komen	gekomen	komen
tuijs gekoomen	thuis|komen	gekoomen	komen
tuijs ge koome	thuis|komen	koome	komen
tuijs gekoome	thuis|komen	gekoome	komen
tuijs gekreege	thuis|krijgen	gekreege	krijgen
tuijs gelaten	thuis|laten	gelaten	laten
tuijs ghekomen	thuis|komen	ghekomen	komen
tuijs ghekommen	thuis|komen	ghekommen	komen
tuijs ghe koomen	thuis|komen	koomen	komen
tuijs ghestyert	thuis|sturen	ghestyert	sturen
tuijs halen	thuis|halen	halen	halen
tuijs hoorde	thuis|horen	hoorde	horen
tuijs koemen	thuis|komen	koemen	komen
tuijs komende	thuis|komen	komende	komen
tuijs komen	thuis|komen	komen	komen
tuijs kome	thuis|komen	kome	komen
tuijs kom	thuis|komen	kom	komen
tuijs komt	thuis|komen	komt	komen
tuijs koomen	thuis|komen	koomen	komen
tuijs koome	thuis|komen	koome	komen
tuijs koomt	thuis|komen	koomt	komen
tuijs krech	thuis|krijgen	krech	krijgen
tuijs quam	thuis|komen	quam	komen
tuijs sende	thuis|zenden	sende	zenden
tuijs stijeren	thuis|sturen	stijeren	sturen
tuijs vaaren	thuis|varen	vaaren	varen
Tuijs vaaren	thuis|varen	vaaren	varen
tuis commen	thuis|komen	commen	komen
tuis comt	thuis|komen	comt	komen
tuis coomen	thuis|komen	coomen	komen
tuis gecomen	thuis|komen	gecomen	komen
tuis gehaldt	thuis|halen	gehaldt	halen
tuis gekome	thuis|komen	gekome	komen
tuis haeldt	thuis|halen	haeldt	halen
tuis komdt	thuis|komen	komdt	komen
tuis komen	thuis|komen	komen	komen
tuis kommen	thuis|komen	kommen	komen
tuis komt	thuis|komen	komt	komen
tuis kriggen	thuis|krijgen	kriggen	krijgen
tus comen	thuis|komen	comen	komen
tus commen	thuis|komen	commen	komen
tus comt	thuis|komen	comt	komen
tus gebleven	thuis|blijven	gebleven	blijven
tus gechregen	thuis|krijgen	gechregen	krijgen
tus gecomen	thuis|komen	gecomen	komen
tus ghelaten	thuis|laten	ghelaten	laten
tus komen	thuis|komen	komen	komen
tus kome	thuis|komen	kome	komen
tus komp	thuis|komen	komp	komen
tus komt	thuis|komen	komt	komen
tus koome	thuis|komen	koome	komen
tus rake	thuis|raken	rake	raken
tuys commen	thuis|komen	commen	komen
tuys gecomen	thuis|komen	gecomen	komen
tuys gekome	thuis|komen	gekome	komen
tuys gekom	thuis|komen	gekom	komen
tuys gekoomen	thuis|komen	gekoomen	komen
tuys houden	thuis|houden	houden	houden
tuys komen	thuis|komen	komen	komen
tuys kommen	thuis|komen	kommen	komen
tuys komt	thuis|komen	komt	komen
tuys koomen	thuis|komen	koomen	komen
Tuys koomen	thuis|komen	koomen	komen
tuys koome	thuis|komen	koome	komen
tuys koom	thuis|komen	koom	komen
tuys koomt	thuis|komen	koomt	komen
tuys kwaamen	thuis|komen	kwaamen	komen
tuys stueren	thuis|sturen	stueren	sturen
tuyst koomen	thuis|komen	koomen	komen
tuys vaare	thuis|varen	vaare	varen
tvijs komen	thuis|komen	komen	komen
tvs commen	thuis|komen	commen	komen
ueijt gevarer	uit|varen	gevarer	varen
uer geet	ver|geten	geet	geten
uer get	ver|geten	get	geten
uer gheuen	ver|geven	gheuen	geven
uer hopende	ver|hopen	hopende	hopen
uer hope	ver|hopen	hope	hopen
uer leenen	ver|lenen	leenen	lenen
uer liesen	ver|liezen	liesen	liezen
uer lost	ver|lossen	lost	lossen
uer mach	ver|mogen	mach	mogen
uer sien	voor|zien	sien	zien
uer staen	ver|staan	staen	staan
uer wachten	ver|wachten	wachten	wachten
uet ghevaren	uit|varen	ghevaren	varen
uid Geschieden	uit|scheiden	Geschieden	scheiden
uid Gestord	uit|storten	Gestord	storten
uiet geuaren	uit|varen	geuaren	varen
uiijt gheroeijt	uit|roeien	gheroeijt	roeien
uijdt geuallen	uit|vallen	geuallen	vallen
uijt bannen	uit|bannen	bannen	bannen
uijt blijft	uit|blijven	blijft	blijven
uijt blijven	uit|blijven	blijven	blijven
uijt breijden	uit|breiden	breijden	breiden
uijt brijden	uit|breiden	brijden	breiden
uijt Brijden	uit|breiden	Brijden	breiden
uijt bringen	uit|brengen	bringen	brengen
uijt comen	uit|komen	comen	komen
uijt deelen	uit|delen	deelen	delen
uijt deijle	uit|delen	deijle	delen
uijt dienen	uit|dienen	dienen	dienen
Uijt Gaan	uit|gaan	Gaan	gaan
uijt gaen	uit|gaan	gaen	gaan
uijt gaet	uit|gaan	gaet	gaan
uijt gebarsten	uit|barsten	gebarsten	barsten
uijt geblaase	uit|blazen	geblaase	blazen
uijt geeft	uit|geven	geeft	geven
uijt geft	uit|geven	geft	geven
uijt gegeven	uit|geven	gegeven	geven
uijt gekocht	uit|kopen	gekocht	kopen
uijt geloost	uit|lozen	geloost	lozen
uijt gemaeckt	uit|maken	gemaeckt	maken
uijt gerecht	uit|richten	gerecht	richten
uijt geslagen	uit|slaan	geslagen	slaan
uijt gesondert	uit|zonderen	gesondert	zonderen
uijt gestaan	uit|staan	gestaan	staan
uijt gestaen	uit|staan	gestaen	staan
uijt gestan	uit|staan	gestan	staan
uijt gestorven	uit|sterven	gestorven	sterven
Uijt gestroijd	uit|strooien	gestroijd	strooien
uijt getrocke	uit|trekken	getrocke	trekken
uijt geuallen	uit|vallen	geuallen	vallen
uijt geuaren	uit|varen	geuaren	varen
uijt gevaaren	uit|varen	gevaaren	varen
uijt gevaeren	uit|varen	gevaeren	varen
uijt Gevallen	uit|vallen	Gevallen	vallen
uijt gevaren	uit|varen	gevaren	varen
uijt ghegaen	uit|gaan	ghegaen	gaan
uijt ghe vaeren	uit|varen	vaeren	varen
uijt hangedt	uit|hangen	hangedt	hangen
uijt hangt	uit|hangen	hangt	hangen
uijt houden	uit|houden	houden	houden
uijt kappen	uit|kappen	kappen	kappen
uijt koommen	uit|komen	koommen	komen
uijt langen	uit|langen	langen	langen
uijt leest	uit|lezen	leest	lezen
uijt loopen	uit|lopen	loopen	lopen
uijt Loopen	uit|lopen	Loopen	lopen
uijt maakte	uit|maken	maakte	maken
uijt rechten	uit|richten	rechten	richten
uijt reen	uit|reden	reen	reden
uijt reijse	uit|reizen	reijse	reizen
uijt roepe	uit|roepen	roepe	roepen
uijt Rooken	uit|roken	Rooken	roken
uijt sag	uit|zien	sag	zien
uijt senden	uit|zenden	senden	zenden
uijt sien	uit|zien	sien	zien
uijt siet	uit|zien	siet	zien
uijt spreken	uit|spreken	spreken	spreken
uijt staan	uit|staan	staan	staan
uijt staen	uit|staan	staen	staan
uijt staet	uit|staan	staet	staan
uijt steeckt	uit|steken	steeckt	steken
uijt stellen	uit|stellen	stellen	stellen
uijt storten	uit|storten	storten	storten
uijt strecken	uit|strekken	strecken	strekken
uijt strekt	uit|strekken	strekt	strekken
uijt tellen	uit|tellen	tellen	tellen
uijtt geloopen	uit|lopen	geloopen	lopen
uijt trockt	uit|trekken	trockt	trekken
uijt vallen	uit|vallen	vallen	vallen
uijt valle	uit|vallen	valle	vallen
uijt valt	uit|vallen	valt	vallen
uijt varen	uit|varen	varen	varen
uijt wachten	uit|wachten	wachten	wachten
uijt wercken	uit|werken	wercken	werken
uit bleef	uit|blijven	bleef	blijven
uit breijden	uit|breiden	breijden	breiden
uit drucken	uit|drukken	drucken	drukken
uit drukken	uit|drukken	drukken	drukken
uit gaen	uit|gaan	gaen	gaan
Uit gaen	uit|gaan	gaen	gaan
uit gehaelt	uit|halen	gehaelt	halen
uit gelopen	uit|lopen	gelopen	lopen
uit geruckt	uit|rukken	geruckt	rukken
uit gescheen	uit|scheiden	gescheen	scheiden
uit gestaan	uit|staan	gestaan	staan
uit gestaen	uit|staan	gestaen	staan
uit geuare	uit|varen	geuare	varen
uit gevallen	uit|vallen	gevallen	vallen
uit gevaren	uit|varen	gevaren	varen
uit gevoert	uit|voeren	gevoert	voeren
uit ghevaren	uit|varen	ghevaren	varen
uit lossen	uit|lossen	lossen	lossen
uit rijcken	uit|reiken	rijcken	reiken
uit siet	uit|zien	siet	zien
uit sijen	uit|zien	sijen	zien
uit sonder	uit|zonderen	sonder	zonderen
Uit terende	uit|teren	terende	teren
uit	uit|gooien	uit	gooien
uit vaert	uit|varen	vaert	varen
uit vallen	uit|vallen	vallen	vallen
uit weesen	uit|zijn	weesen	zijn
uit werken	uit|werken	werken	werken
uit zonderen	uit|zonderen	zonderen	zonderen
unt vangen	ont|vangen	vangen	vangen
urij komen	vrij|komen	komen	komen
uten geplundert	uit|plunderen	geplundert	plunderen
uten gesopen	uit|zuipen	gesopen	zuipen
ut geuaren	uit|varen	geuaren	varen
uydt borgen	uit|borgen	borgen	borgen
uydt brengen	uit|brengen	brengen	brengen
uydt leueren	uit|leveren	leueren	leveren
uydt sag	uit|zien	sag	zien
uyt barsten	uit|barsten	barsten	barsten
uyt falen	uit|vallen	falen	vallen
uyt gaan	uit|gaan	gaan	gaan
uyt gan	uit|gaan	gan	gaan
uyt gedeeld	uit|delen	gedeeld	delen
uyt gegaan	uit|gaan	gegaan	gaan
uyt gekreegen	uit|krijgen	gekreegen	krijgen
uyt gelagt	uit|lachen	gelagt	lachen
Uyt gelevert	uit|leveren	gelevert	leveren
uyt gericht	uit|richten	gericht	richten
uyt gerust	uit|rusten	gerust	rusten
uyt geSongen	uit|zingen	geSongen	zingen
uyt gestaan	uit|staan	gestaan	staan
uyt geuaren	uit|varen	geuaren	varen
uyt gevallen	uit|vallen	gevallen	vallen
uyt gevaren	uit|varen	gevaren	varen
uyt ghevaren	uit|varen	ghevaren	varen
uyt hangt	uit|hangen	hangt	hangen
uyt koomen	uit|komen	koomen	komen
uyt leeveren	uit|leveren	leeveren	leveren
uyt maake	uit|maken	maake	maken
uyt noemen	uit|noemen	noemen	noemen
uyt Rechten	uit|richten	Rechten	richten
uyt rusten	uit|rusten	rusten	rusten
uyt schijden	uit|scheiden	schijden	scheiden
uyt sien	uit|zien	sien	zien
uyt slijten	uit|slijten	slijten	slijten
Uyt Valt	uit|vallen	Valt	vallen
uyt walen	uit|vallen	walen	vallen
vaard wel	varen|wel	vaard	varen
Vaard wel	varen|wel	Vaard	varen
vaare wel	varen|wel	vaare	varen
vaart well	varen|wel	vaart	varen
vaart wel	varen|wel	vaart	varen
Vaart wel	varen|wel	Vaart	varen
Vaart Wel	varen|wel	Vaart	varen
Vaart Wel.	varen|wel	Vaart	varen
Vaar wel	varen|wel	Vaar	varen
vaeren wel	varen|wel	vaeren	varen
vaer leenen	ver|lenen	leenen	lenen
vaert mee	varen|mee	vaert	varen
vaert wel	varen|wel	vaert	varen
vaer wel	varen|wel	vaer	varen
vald af	vallen|af	vald	vallen
vald uyt	vallen|uit	vald	vallen
valt af	vallen|af	valt	vallen
valt lastig	vallen|lastig	valt	vallen
Valt uyt	vallen|uit	Valt	vallen
valt voor	vallen|voor	valt	vallen
van Een Gescheurd	vaneen|scheuren	Gescheurd	scheuren
vanght aen	vangen|aan	vanght	vangen
vard wel	varen|wel	vard	varen
vart weel	varen|wel	vart	varen
vart wel	varen|wel	vart	varen
var wel	varen|wel	var	varen
vast geknoopt	vast|knopen	geknoopt	knopen
vast gemaakt	vast|maken	gemaakt	maken
Vast Gespeijkert	vast|spijkeren	Gespeijkert	spijkeren
vast gestelt	vast|stellen	gestelt	stellen
vast hegt	vast|hechten	hegt	hechten
vast houde	vast|houden	houde	houden
vast maaken	vast|maken	maaken	maken
vast maak	vast|maken	maak	maken
vast stont	vast|staan	stont	staan
veegt aff	vegen|af	veegt	vegen
veer choecht	ver|kopen	choecht	kopen
veer geet	ver|geten	geet	geten
veer hoeppen	ver|hopen	hoeppen	hopen
veer hopende	ver|hopen	hopende	hopen
veer hope	ver|hopen	hope	hopen
veer hoppen	ver|hopen	hoppen	hopen
veer koecht	ver|kopen	koecht	kopen
veer kooecht	ver|kopen	kooecht	kopen
veer trock	ver|trekken	trock	trekken
veer weecken	ver|wekken	weecken	wekken
vel gaen	wel|gaan	gaen	gaan
ver aes te reerre	ver|assureren	reerre	assureren
ver anderen	ver|anderen	anderen	anderen
ver beiden	ver|beiden	beiden	beiden
ver Bende	ver|binden	Bende	binden
verbij gaen	voorbij|gaan	gaen	gaan
ver blenden	ver|blinden	blenden	blinden
ver blijf	ver|blijven	blijf	blijven
ver blijue	ver|blijven	blijue	blijven
ver Blijve	ver|blijven	Blijve	blijven
Ver blijve	ver|blijven	blijve	blijven
Ver Blijve	ver|blijven	Blijve	blijven
Ver Blyve	ver|blijven	Blyve	blijven
ver cocht	ver|kopen	cocht	kopen
ver Coft	ver|kopen	Coft	kopen
ver coopen	ver|kopen	coopen	kopen
verder gaat	verder|gaan	gaat	gaan
verdrije te	ver|drieten	te	drieten
ver eenigen	ver|enigen	eenigen	enigen
ver Excuseeren	ver|excuseren	Excuseeren	excuseren
ver Gaan	ver|gaan	Gaan	gaan
ver gaen	ver|gaan	gaen	gaan
ver geet	ver|geten	geet	geten
ver geven	ver|geven	geven	geven
ver gheter	ver|geten	gheter	geten
ver goedt	ver|goeden	goedt	goeden
ver halen	ver|halen	halen	halen
verhiepo tieceert	ver|hypothekeren	tieceert	hypothekeren
ver hinderen	ver|hinderen	hinderen	hinderen
ver hoede	ver|hoeden	hoede	hoeden
ver hoepende	ver|hopen	hoepende	hopen
ver hoepe	ver|hopen	hoepe	hopen
ver hoep	ver|hopen	hoep	hopen
ver hoopenden	ver|hopen	hoopenden	hopen
ver hoo pende	ver|hopen	hoo	hopen
ver hoopende	ver|hopen	hoopende	hopen
verhoopen de	ver|hopen	de	hopen
ver hoope	ver|hopen	hoope	hopen
Ver hoope	ver|hopen	hoope	hopen
ver hoopt	ver|hopen	hoopt	hopen
ver hoop	ver|hopen	hoop	hopen
ver ho penden	ver|hopen	ho	hopen
verhopen den	ver|hopen	den	hopen
verhopen de	ver|hopen	de	hopen
ver hopen	ver|hopen	hopen	hopen
ver hope	ver|hopen	hope	hopen
ver hop	ver|hopen	hop	hopen
ver hove	ver|hopen	hove	hopen
ver huijst	ver|huizen	huijst	huizen
Ver huren	ver|huren	huren	huren
ver kocht	ver|kopen	kocht	kopen
ver koct kocht	ver|kopen	koct	kopen
ver koft	ver|kopen	koft	kopen
ver kogt	ver|kopen	kogt	kopen
ver koogt	ver|kopen	koogt	kopen
ver koopen	ver|kopen	koopen	kopen
ver koos	ver|kiezen	koos	kiezen
ver kort	ver|korten	kort	korten
ver laate	ver|laten	laate	laten
ver laatte	ver|laten	laatte	laten
ver lanckt	ver|langen	lanckt	langen
ver landt	ver|langen	landt	langen
ver lange	ver|langen	lange	langen
ver langht	ver|langen	langht	langen
ver langt	ver|langen	langt	langen
ver lang	ver|langen	lang	langen
ver leenen	ver|lenen	leenen	lenen
ver leene	ver|lenen	leene	lenen
ver lenen	ver|lenen	lenen	lenen
ver len	ver|lenen	len	lenen
ver leyje	ver|leiden	leyje	leiden
ver lienen	ver|lenen	lienen	lenen
ver liesen	ver|liezen	liesen	liezen
ver looren	ver|liezen	looren	liezen
ver loren	ver|liezen	loren	liezen
ver lost	ver|lossen	lost	lossen
ver mac	ver|mogen	mac	mogen
ver maent	ver|manen	maent	manen
ver magh	ver|mogen	magh	mogen
ver merdert	ver|meerderen	merdert	meerderen
ver mocht	ver|mogen	mocht	mogen
ver myne	ver|menen	myne	menen
ver namen	ver|nemen	namen	nemen
ver neemen	ver|nemen	neemen	nemen
ver neemt	ver|nemen	neemt	nemen
ver neme	ver|nemen	neme	nemen
ver noomen	ver|nemen	noomen	nemen
vernoom men	ver|nemen	men	nemen
ver ongelukt	ver|ongelukken	ongelukt	ongelukken
ver oorsaakt	ver|oorzaken	oorsaakt	oorzaken
ver overt	ver|overen	overt	overen
ver pligte	ver|plichten	pligte	plichten
ver sameelt	ver|zamelen	sameelt	zamelen
ver scheijnen	ver|schijnen	scheijnen	schijnen
verscheuren van Een	verscheuren|vaneen	verscheuren	verscheuren
ver setten	ver|zetten	setten	zetten
ver set	ver|zetten	set	zetten
ver sien	voor|zien	sien	zien
ver sijee	ver|zien	sijee	zien
ver sijen	voor|zien	sijen	zien
ver soeck	ver|zoeken	soeck	zoeken
ver soek	ver|zoeken	soek	zoeken
ver soght	ver|zoeken	soght	zoeken
ver sogt	ver|zoeken	sogt	zoeken
ver soik	ver|zoeken	soik	zoeken
ver sorgen	ver|zorgen	sorgen	zorgen
ver souk	ver|zoeken	souk	zoeken
ver staan	ver|staan	staan	staan
ver staen	ver|staan	staen	staan
ver stercke	ver|sterken	stercke	sterken
ver stooten	ver|stoten	stooten	stoten
ver suijme	ver|zuimen	suijme	zuimen
ver suijmt	ver|zuimen	suijmt	zuimen
ver techken	ver|trekken	techken	trekken
ver trecken	ver|trekken	trecken	trekken
ver trekken	ver|trekken	trekken	trekken
ver trooste	ver|troosten	trooste	troosten
vertrou toe	vertrouwen|toe	vertrou	vertrouwen
ver trout	ver|trouwen	trout	trouwen
ver trou	ver|trouwen	trou	trouwen
veruers schen	ver|versen	schen	versen
ver vachten	ver|wachten	vachten	wachten
ver vallen	ver|vallen	vallen	vallen
ver volgh	ver|volgen	volgh	volgen
verwaardig t	ver|waardigen	t	waardigen
ver wachten	ver|wachten	wachten	wachten
ver wachte	ver|wachten	wachte	wachten
ver wach	ver|wachten	wach	wachten
ver wagtende	ver|wachten	wagtende	wachten
ver wonderen	ver|wonderen	wonderen	wonderen
ver wonen	ver|wonen	wonen	wonen
ver zien	voor|zien	zien	zien
ver zoeck	ver|zoeken	zoeck	zoeken
ver zoekt	ver|zoeken	zoekt	zoeken
ver Zoekt	ver|zoeken	Zoekt	zoeken
vielen om ver	vallen|omver	vielen	vallen
viel om verde	vallen|omver	viel	vallen
viel voor	vallen|voor	viel	vallen
vijt blijue	uit|blijven	blijue	blijven
vijt geleijde	uit|leggen	geleijde	leggen
vijt ge scildert	uit|schilderen	scildert	schilderen
vijt gestaen	uit|staan	gestaen	staan
vijt gevaren	uit|varen	gevaren	varen
vijt ge vare	uit|varen	vare	varen
vijt gevare	uit|varen	gevare	varen
vijt gewest	zijn|uit	vijt	zijn
vijt gooijt	uit|gooien	gooijt	gooien
vijt siet	uit|zien	siet	zien
vijt sijet	uit|zien	sijet	zien
vijt vallen	uit|vallen	vallen	vallen
vijt valle	uit|vallen	valle	vallen
Vindt Plaats	vinden|plaats	Vindt	vinden
vit gesondert	uit|zonderen	gesondert	zonderen
vit gevaren	uit|varen	gevaren	varen
vit rech ten	uit|richten	rech	richten
vit seij den	uit|scheiden	seij	scheiden
vit sijnde	uit|zijn	sijnde	zijn
vit trecken	uit|trekken	trecken	trekken
vit valle	uit|vallen	valle	vallen
Voege toe	voegen|toe	Voege	voegen
voer beteren	ver|beteren	beteren	beteren
voerdt gaen	voort|gaan	gaen	gaan
voer koeft	ver|kopen	koeft	kopen
voer sien	voor|zien	sien	zien
voer sock	ver|zoeken	sock	zoeken
voer trecken	ver|trekken	trecken	trekken
vol brengen	vol|brengen	brengen	brengen
vol brenge	vol|brengen	brenge	brengen
vol daan	vol|doen	daan	doen
vol doen	vol|doen	doen	doen
vol gelaaden	vol|laden	gelaaden	laden
volgen nae	volgen|na	volgen	volgen
volght na	volgen|na	volght	volgen
vol laaden	vol|laden	laaden	laden
vol laen	vol|laden	laen	laden
voll Raecken	vol|raken	Raecken	raken
vol mackt	vol|maken	mackt	maken
vooert ghetrocken	voort|trekken	ghetrocken	trekken
vool daen	vol|doen	daen	doen
vool ent	vol|einden	ent	einden
voor bij gaan	voorbij|gaan	gaan	gaan
voorbij gaan	voorbij|gaan	gaan	gaan
VoorBij Gaan	voorbij|gaan	Gaan	gaan
voor bij gaen	voorbij|gaan	gaen	gaan
voorbij gaen	voorbij|gaan	gaen	gaan
voorbij gegaan	voorbij|gaan	gegaan	gaan
voorbij slippen	voorbij|slippen	slippen	slippen
voor blieue	ver|blijven	blieue	blijven
voor brand	ver|branden	brand	branden
voorby gaan	voorbij|gaan	gaan	gaan
voorby gaet	voorbij|gaan	gaet	gaan
Voorby gezeyld	voorbij|zeilen	gezeyld	zeilen
voor deelt	ver|delen	deelt	delen
voord gaad	voort|gaan	gaad	gaan
voor dragen	ver|dragen	dragen	dragen
voordt bestellen	voort|bestellen	bestellen	bestellen
voordt brenge	voort|brengen	brenge	brengen
voor dure	voort|duren	dure	duren
voor ffaalt	voor|vallen	ffaalt	vallen
voor gaen	voor|gaan	gaen	gaan
voor gaf	voor|geven	gaf	geven
voor gedaan	voor|doen	gedaan	doen
voor gedaen	voor|doen	gedaen	doen
voor gegaen	voor|gaan	gegaen	gaan
voor gehouden	voor|houden	gehouden	houden
voor gekoomen	voor|komen	gekoomen	komen
voor gestelt	voor|stellen	gestelt	stellen
voor geuallen	voor|vallen	geuallen	vallen
voor gevallen	voor|vallen	gevallen	vallen
voor geven	voor|geven	geven	geven
voor ghegeven	voor|geven	ghegeven	geven
voor ghelesen	voor|lezen	ghelesen	lezen
voor heeft	voor|hebben	heeft	hebben
voor helpen	voort|helpen	helpen	helpen
voor hevt	voor|hebben	hevt	hebben
voor hoede	ver|hoeden	hoede	hoeden
voor hoope	ver|hopen	hoope	hopen
voor hoop	ver|hopen	hoop	hopen
voor klaert	ver|klaren	klaert	klaren
voor komt	voor|komen	komt	komen
voor koomen	voor|komen	koomen	komen
voor kopen	ver|kopen	kopen	kopen
voor lange	ver|langen	lange	langen
voor leezen	voor|lezen	leezen	lezen
voor len	ver|langen	len	langen
voor Loopende	voor|lopen	Loopende	lopen
voor Loopen	voor|lopen	Loopen	lopen
voor looren	ver|liezen	looren	liezen
voor nedere	ver|nederen	nedere	nederen
voor nemet	ver|nemen	nemet	nemen
voor ongeluckt	ver|ongelukken	ongeluckt	ongelukken
voor quam	voor|komen	quam	komen
voor sien	voor|zien	sien	zien
voor socht	ver|zoeken	socht	zoeken
voor sockt	ver|zoeken	sockt	zoeken
voor sock	ver|zoeken	sock	zoeken
voor staen	voor|staan	staen	staan
voor stellen	voor|stellen	stellen	stellen
voort behandegen	voort|be|handigen	behandegen	handigen
voort behandigen	voort|be|handigen	behandigen	handigen
voort behandige	voort|be|handigen	behandige	handigen
voort behandighen	voort|be|handigen	behandighen	handigen
voort behandijghen	voort|be|handigen	behandijghen	handigen
voort bestelen	voort|bestellen	bestelen	bestellen
voort bestellen	voort|bestellen	bestellen	bestellen
voort Bestellen	voort|bestellen	Bestellen	bestellen
voort bestelle	voort|bestellen	bestelle	bestellen
voort bestelt	voort|bestellen	bestelt	bestellen
Voort gaan	voort|gaan	gaan	gaan
voort gaat	voort|gaan	gaat	gaan
voort gaende	voort|gaan	gaende	gaan
voort gaen	voort|gaan	gaen	gaan
voort gaet	voort|gaan	gaet	gaan
voort geholpen	voort|helpen	geholpen	helpen
voort geleijde	voort|geleiden	geleijde	geleiden
voort geracken	voort|geraken	geracken	geraken
voort geraken	voort|geraken	geraken	geraken
voort geroeijt	voort|roeien	geroeijt	roeien
voort geschooten	voort|schieten	geschooten	schieten
voort geseijlt	voort|zeilen	geseijlt	zeilen
voort getrocken	voort|trekken	getrocken	trekken
voort gheeuen	voort|geven	gheeuen	geven
voort ghet	voort|gaan	ghet	gaan
Voort Ging	voort|gaan	Ging	gaan
voort helpen	voort|helpen	helpen	helpen
Voort komen	voort|komen	komen	komen
voor trecken	ver|trekken	trecken	trekken
voort schrijve	voort|schrijven	schrijve	schrijven
voort senden	voort|zenden	senden	zenden
voort setten	voort|zetten	setten	zetten
voort Sette	voort|zetten	Sette	zetten
voort vaaren	voort|varen	vaaren	varen
voort verkoopen	voort|verkopen	verkoopen	verkopen
voort	voort|be|handigen	voort	handigen
voort zend	voort|zenden	zend	zenden
voor uijt senden	vooruit|zenden	senden	zenden
voor uijt sont	vooruit|zenden	sont	zenden
voor uyt senden	vooruit|zenden	senden	zenden
voor valdt	voor|vallen	valdt	vallen
voor vallen	voor|vallen	vallen	vallen
voor valt	voor|vallen	valt	vallen
voor viel	voor|vallen	viel	vallen
voor walt	voor|vallen	walt	vallen
voor wenden	voor|wenden	wenden	wenden
voor werpen	voor|werpen	werpen	werpen
voor wondert	ver|wonderen	wondert	wonderen
voor wt sende	vooruit|zenden	sende	zenden
voor zien	voor|zien	zien	zien
vorder gaen	verder|gaan	gaen	gaan
vor hoepe	ver|hopen	hoepe	hopen
vor hoep	ver|hopen	hoep	hopen
vorhopen de	ver|hopen	de	hopen
vor hope	ver|hopen	hope	hopen
vor kocht	ver|kopen	kocht	kopen
Vor Koft	ver|kopen	Koft	kopen
vor kregen	ver|krijgen	kregen	krijgen
vor laeten	ver|laten	laeten	laten
vor leene	ver|lenen	leene	lenen
vor lene	ver|lenen	lene	lenen
vor lijnen	ver|lenen	lijnen	lenen
vor lijnt	ver|lenen	lijnt	lenen
vor nem end	ver|nemen	nem	nemen
vor socket	ver|zoeken	socket	zoeken
vor sock	ver|zoeken	sock	zoeken
vor soeke	ver|zoeken	soeke	zoeken
vor staen	ver|staan	staen	staan
vor sta	ver|staan	sta	staan
vor suijmbt	ver|zuimen	suijmbt	zuimen
vort behandige	voort|be|handigen	behandige	handigen
vort bestellen	voort|bestellen	bestellen	bestellen
vort gegaan	voort|gaan	gegaan	gaan
vort komen	voort|komen	komen	komen
vort kom	voort|komen	kom	komen
voruijt sag	vooruit|zien	sag	zien
vor Vngeluck	ver|ongelukken	Vngeluck	ongelukken
vor wacht	ver|wachten	wacht	wachten
vraten uijt	vreten|uit	vraten	vreten
vreet op	vreten|op	vreet	vreten
vreij Gegeven	vrij|geven	Gegeven	geven
vrij gescharteld	vrij|charteren	gescharteld	charteren
vrij maecken	vrij|maken	maecken	maken
vry gegeeve	vrij|geven	gegeeve	geven
Vt genomen	uit|nemen	genomen	nemen
Vt halde	uit|halen	halde	halen
vuege toe	voegen|toe	vuege	voegen
vyt gevaren	uit|varen	gevaren	varen
waar	mee|nemen	waar	nemen
waar neemen	waar|nemen	neemen	nemen
waar Neeme	waar|nemen	Neeme	nemen
waar neem	waar|nemen	neem	nemen
waer gecout	weer|kopen	gecout	kopen
waer neemen	waar|nemen	neemen	nemen
waer nemen	waar|nemen	nemen	nemen
waer schoen	waar|schuwen	schoen	schuwen
waer schouwen	waar|schuwen	schouwen	schuwen
wech crijgen	weg|krijgen	crijgen	krijgen
wech gaen	weg|gaan	gaen	gaan
wech gaet	weg|gaan	gaet	gaan
wech gelopen	weg|lopen	gelopen	lopen
wech genomen	weg|nemen	genomen	nemen
wech geruct	weg|rukken	geruct	rukken
wech gesonde	weg|zenden	gesonde	zenden
wech gestijert	weg|sturen	gestijert	sturen
Wech gestollen	weg|stelen	gestollen	stelen
wech ghebrocht	weg|brengen	ghebrocht	brengen
wech ghefen	weg|geven	ghefen	geven
wech gijn	weg|gaan	gijn	gaan
wech ginck	weg|gaan	ginck	gaan
wech halen	weg|halen	halen	halen
wech krijgen	weg|krijgen	krijgen	krijgen
wech leghen	weg|leggen	leghen	leggen
wecht gaen	weg|gaan	gaen	gaan
Weck naem	nemen|weg	Weck	nemen
wedder seen	weer|zien	seen	zien
weder bekommet	weder|bekomen	bekommet	bekomen
weder breijngen	weder|brengen	breijngen	brengen
weder comen	weder|komen	comen	komen
weder Crijgen	weer|krijgen	Crijgen	krijgen
weder geuen	weder|geven	geuen	geven
weder gevonden	weer|vinden	gevonden	vinden
weder ghekreghen	weer|krijgen	ghekreghen	krijgen
weder groeten	weder|groeten	groeten	groeten
weder keeren	weder|keren	keeren	keren
weder keere	weder|keren	keere	keren
weder komen	weder|komen	komen	komen
weder kreegh	weer|krijgen	kreegh	krijgen
weder leggen	weer|leggen	leggen	leggen
wederom becomen	weder|ombekomen	becomen	ombekomen
wederom brengen	weder|ombrengen	brengen	ombrengen
wederom chrygen	weder|omkrijgen	chrygen	omkrijgen
wederom comen	weder|omkomen	comen	omkomen
weder om comt	weder|omkomen	om	omkomen
wederom gegeven	weder|omgeven	gegeven	omgeven
wederom gekeert	weder|omkeren	gekeert	omkeren
wederom geuen	weder|omgeven	geuen	omgeven
wederom geven	weder|omgeven	geven	omgeven
weder om gezonden	weder|omzenden	gezonden	omzenden
wederom groeten	weder|omgroeten	groeten	omgroeten
wederom hebben	weder|omhebben	hebben	omhebben
weder om heb	weder|omhebben	heb	omhebben
wederom horen	weder|omhoren	horen	omhoren
wederom keeren	weder|omkeren	keeren	omkeren
wederom krijgen	weder|omkrijgen	krijgen	omkrijgen
wederom sende	weder|omzenden	sende	omzenden
wederom sien	weder|omzien	sien	omzien
wederom sijen	weder|omzien	sijen	omzien
wederom sijn	weder|omzien	sijn	omzien
wederom spreeken	weder|omspreken	spreeken	omspreken
wederom sturen	weder|omsturen	sturen	omsturen
wederom vergelde	weder|omvergelden	vergelde	omvergelden
weder om	weder|omzien	om	omzien
wederom zenden	weder|omzenden	zenden	omzenden
weder quaem	weder|omkomen	quaem	omkomen
weder sag	weer|zien	sag	zien
weder schrijff	weder|schrijven	schrijff	schrijven
weder schrijven	weder|schrijven	schrijven	schrijven
weder seen	weer|zien	seen	zien
weder sien	weer|zien	sien	zien
weder sijen	weer|zien	sijen	zien
weder staen	weer|staan	staen	staan
weder vaert	weder|varen	vaert	varen
weder verdiene	weder|verdienen	verdiene	verdienen
weder zien	weer|zien	zien	zien
weeder brengen	weder|brengen	brengen	brengen
weeder comt	weder|komen	comt	komen
weeder gaen	weer|gaan	gaen	gaan
weeder Geeven	weer||geven	Geeven	geven
weeder geeve	weer||geven	geeve	geven
weeder keeren	weder|keren	keeren	keren
weeder neemen	weder|nemen	neemen	nemen
weederom brengen	weder|ombrengen	brengen	ombrengen
weederom gehadt	weder|omhebben	gehadt	omhebben
weederom geven	weder|omgeven	geven	omgeven
weeder om koomen	weder|omkomen	koomen	omkomen
weederom koomen	weder|omkomen	koomen	omkomen
weederom schrijven	weder|omschrijven	schrijven	omschrijven
weederom sende	weder|omzenden	sende	omzenden
weederom sien	weder|omzien	sien	omzien
weeder schreyven	weder|schrijven	schreyven	schrijven
weeder schrijft	weder|schrijven	schrijft	schrijven
weeder schrijven	weder|schrijven	schrijven	schrijven
weeder sien	weer|zien	sien	zien
weeder sprecken	weder|spreken	sprecken	spreken
weeder vinden	weer|vinden	vinden	vinden
weeder	omkomen|weder	weeder	omkomen
weeg gaet	weg|gaan	gaet	gaan
weeg genoomen	weg|nemen	genoomen	nemen
weeg gestopt	weg|stoppen	gestopt	stoppen
weel gaan	wel|gaan	gaan	gaan
weens toe	wensen|toe	weens	wensen
weer comt	weer|komen	comt	komen
weer coomen	weer|komen	coomen	komen
weerder sien	weder|zien	sien	zien
weer geeven	weer||geven	geeven	geven
weer Gekome	weer|komen	Gekome	komen
weer gekregen	weer|krijgen	gekregen	krijgen
weer gesien	weder|zien	gesien	zien
weer gesien	weer|zien	gesien	zien
weer gestuurt	weder|sturen	gestuurt	sturen
weer geven	weder|geven	geven	geven
weer gruten	weder|groeten	gruten	groeten
weer hale	weder|halen	hale	halen
weer hebben	we(d)er|hebben	hebben	hebben
weer keren	weer|keren	keren	keren
weer koomen	weer|komen	koomen	komen
Weer koomen	weer|komen	koomen	komen
weer koome	weer|komen	koome	komen
Weer Kreigen	weer|krijgen	Kreigen	krijgen
weer krijgen	weer|krijgen	krijgen	krijgen
weer krygen	weer|krijgen	krygen	krijgen
weer kryghen	weer|krijgen	kryghen	krijgen
weer om bringen	weerom|brengen	bringen	brengen
weer om creegen	weerom|krijgen	creegen	krijgen
weerom gekomen	weerom|komen	gekomen	komen
weer om gekreegen	weerom|krijgen	gekreegen	krijgen
weerom gekreegen	weerom|krijgen	gekreegen	krijgen
weerom gekrege	weerom|krijgen	gekrege	krijgen
weerom keerden	weerom|keren	keerden	keren
weer om keeren	weerom|keren	keeren	keren
weer om komen	weerom|komen	komen	komen
weer om kome	weerom|komen	kome	komen
weer om kommen	weerom|komen	kommen	komen
weer om komt	weerom|komen	komt	komen
weer om krygen	weerom|krijgen	krygen	krijgen
weerom senden	weerom|zenden	senden	zenden
weer om sende	weder|omzenden	sende	omzenden
weer om sien	weerom|zien	sien	zien
weerom sien	weerom|zien	sien	zien
weer om sijen	weerom|zien	sijen	zien
weer quam	weer|komen	quam	komen
weer sagen	weer|zien	sagen	zien
weer schrijue	we(d)er|schrijven	schrijue	schrijven
weer seen	weer|zien	seen	zien
weer sien	weer|zien	sien	zien
weer sijen	weer|zien	sijen	zien
weer sijn	weer|zien	sijn	zien
weer sprack	weer|spreken	sprack	spreken
weer syen	weer|zien	syen	zien
weer vinden	weer|vinden	vinden	vinden
weer winnen	we(d)er|winnen	winnen	winnen
weer zeen	weer|zien	zeen	zien
weer ziens	weer|zien	ziens	zien
weer zien	weder|zien	zien	zien
weer Zien	weder|zien	Zien	zien
weer zien	weer|zien	zien	zien
weer Zien	weer|zien	Zien	zien
Weer Zien	weer|zien	Zien	zien
weer zijeen	weer|zien	zijeen	zien
weg bleijft	weg|blijven	bleijft	blijven
weg dreven	weg|drijven	dreven	drijven
weg gaan	weg|gaan	gaan	gaan
weg gedraage	weg|dragen	gedraage	dragen
weg gedreeven	weg|drijven	gedreeven	drijven
weg gejaagt	weg|jagen	gejaagt	jagen
weg geligd	weg|leggen	geligd	leggen
weg geloopen	weg|lopen	geloopen	lopen
weg genoomen	weg|nemen	genoomen	nemen
weg gerukt	weg|rukken	gerukt	rukken
weg geschoten	weg|schieten	geschoten	schieten
weg geslaagen	weg|slaan	geslaagen	slaan
weg Geslaagen	weg|slaan	Geslaagen	slaan
weg geslagen	weg|slaan	geslagen	slaan
weg gespoelt	weg|spoelen	gespoelt	spoelen
weg Gespoelt	weg|spoelen	Gespoelt	spoelen
weg Geve	weg|geven	Geve	geven
Weg gewaaijt	weg|waaien	gewaaijt	waaien
weg gezet	weg|zetten	gezet	zetten
wegh blijft	weg|blijven	blijft	blijven
weg helpen	weg|helpen	helpen	helpen
wegh gaen	weg|gaan	gaen	gaan
wegh gaet	weg|gaan	gaet	gaan
wegh gegeven	weg|geven	gegeven	geven
wegh genomen	weg|nemen	genomen	nemen
wegh gesonden	weg|zenden	gesonden	zenden
wegh gink	weg|gaan	gink	gaan
wegh halen	weg|halen	halen	halen
wegh krijgen	weg|krijgen	krijgen	krijgen
wegh trock	weg|trekken	trock	trekken
weg koome	weg|komen	koome	komen
weg kreijgen	weg|krijgen	kreijgen	krijgen
weg kreygen	weg|krijgen	kreygen	krijgen
weg krijge	weg|krijgen	krijge	krijgen
weg krygen	weg|krijgen	krygen	krijgen
weg kryge	weg|krijgen	kryge	krijgen
weg leggen	weg|leggen	leggen	leggen
weg neeme	weg|nemen	neeme	nemen
weg nemen	weg|nemen	nemen	nemen
weg raken	weg|raken	raken	raken
weg ruken	weg|rukken	ruken	rukken
weg rukken	weg|rukken	rukken	rukken
weg stuurt	weg|sturen	stuurt	sturen
wek genomen	weg|nemen	genomen	nemen
wek kreege	weg|krijgen	kreege	krijgen
wek sende	weg|zenden	sende	zenden
wekt op	wekken|op	wekt	wekken
wel doen	wel|doen	doen	doen
wel doet	wel|doen	doet	doen
wel gaad	wel|gaan	gaad	gaan
wel gaan	wel|gaan	gaan	gaan
wel Gaan	wel|gaan	Gaan	gaan
wel gaat	wel|gaan	gaat	gaan
wel gadt	wel|gaan	gadt	gaan
wel gaedt	wel|gaan	gaedt	gaan
wel Gaedt	wel|gaan	Gaedt	gaan
wel gaen	wel|gaan	gaen	gaan
wel gaet	wel|gaan	gaet	gaan
wel Gane	wel|gaan	Gane	gaan
wel gan	wel|gaan	gan	gaan
wel gedaen	wel|doen	gedaen	doen
wel geuallen	wel|gevallen	geuallen	gevallen
Well Gaan	wel|gaan	Gaan	gaan
Well gedaan	wel|doen	gedaan	doen
wel staan	wel|staan	staan	staan
wel vaert	wel|varen	vaert	varen
wel varen	wel|varen	varen	varen
wend aan	wenden|aan	wend	wenden
Wende af	wenden|af	Wende	wenden
wenschenden toen	wensen|toe	wenschenden	wensen
wenschende toe	wensen|toe	wenschende	wensen
wenschen toe	wensen|toe	wenschen	wensen
wensche toe	wensen|toe	wensche	wensen
wensche Toe	wensen|toe	wensche	wensen
Wensche too	wensen|toe	Wensche	wensen
wensede too	wensen|toe	wensede	wensen
wensschen toe	wensen|toe	wensschen	wensen
wensse toe	wensen|toe	wensse	wensen
wens toe	wensen|toe	wens	wensen
wer coopen	ver|kopen	coopen	kopen
werden waer	worden|gewaar	werden	worden
wer geuen	weer||geven	geuen	geven
wer komen	weer|komen	komen	komen
wer kom me	weer|komen	kom	komen
werom schrijven	weerom|schrijven	schrijven	schrijven
werom sturt	weerom|sturen	sturt	sturen
wer schrive	weder|schrijven	schrive	schrijven
wer sien	weer|zien	sien	zien
wer sijen	weer|zien	sijen	zien
wer staen	ver|staan	staen	staan
wijeren ghewaer	worden|gewaar	wijeren	worden
wijes gemaeckt	wijs|maken	gemaeckt	maken
wijs gemaackt	wijs|maken	gemaackt	maken
wijs maeckte	wijs|maken	maeckte	maken
wijst aan	wijzen|aan	wijst	wijzen
wint uyt	winnen|uit	wint	winnen
word gewaar	worden|gewaar	word	worden
wt geloopen	uit|lopen	geloopen	lopen
wt geplundert	uit|plunderen	geplundert	plunderen
wt gesonden	uit|zenden	gesonden	zenden
wt geuen	uit|geven	geuen	geven
wt gevaren	uit|varen	gevaren	varen
wtge varen	uit|varen	varen	varen
wt kome	uit|komen	kome	komen
wt recke	uit|rekken	recke	rekken
zeg aan	zeggen|aan	zeg	zeggen
zegge dank	zeggen|dank	zegge	zeggen
zegge vaarwel	zeggen|vaarwel	zegge	zeggen
Zende weeder	zenden|we(d)er	Zende	zenden
zet voort	zetten|voort	zet	zetten
zien tegemoet	zien|tegemoet	zien	zien
zie te gemoed	zien|tegemoet	zie	zien
ziet er uit	zien|er|uit	ziet	zien
zie toe	zien|toe	zie	zien
Ziet om	zien|om	Ziet	zien
ziet uit	zien|uit	ziet	zien
zijgt neder	zijgen|neer	zijgt	zijgen
zink weg	zinken|weg	zink	zinken
