19.January	negentiende_januari
200ste.	tweehonderdste
22.octob	tweeëntwintigste_oktober
30.sten	dertigste
4.November	vierde_november
6.ste	zes_stuk
9bre.	november
aan.	aan
aan.	aandoen
aan.	aankomen
aan.	daaraan
aangaande.	aangaande
aangebragt.	aanbrengen
aanschouen.	aanschouwen
aanschouwen.	aanschouwen
aantevaarden.	te_aanvaarden
aantreffen.	aantreffen
Aantreffen.	aantreffen
accepteeren.	accepteren
accorderen.	accorderen
Achtb.	achtbaar
achten.	acht
achting.	achting
adjeu.	adieu
advenant.	advenant
adverteeren.	adverteren
adviseren.	adviseren
aenbieden.	aanbieden
Aenden.	aan_de
aendenken.	aandenken
aengelegen.	aangelegen
aenloopt.	aanlopen
aenmr.	aan_meester
aenvallen.	aanval
af.	afwenden
af.	en_afbrassen
affgeeven.	afgeven
afleg.	afleggen
afsmekenden.	afsmeken
afteleeveren.	te_afleveren
afwagtende.	afwachten
afzyn.	afzijn
Agens.	Agens 
aghting.	hoogachting
agterblyven.	achterblijven
agting.	achting
Agustijus.	augustus
Alcmaer.	Alkmaar
aldaar.	aldaar
Alderliefste.	allerliefste
alleen.	alleen
allerteijd.	al_tijd
Allesbeschermenden.	allesbeschermende
als.	als
als.ghij	als_gij
Alting.	Alting
#Ambr.	Ambrosius
#amc.	Noord-Amerikaans
amen.	amen
Amen.	amen
Amst.	Amsterdam
amsterdam.	Amsterdam
Amsterdam.	Amsterdam
#amsterd.,	Amsterdam
A.M.vander	A._M._Van der Sluijs - Tulleken
An.	aan
ander.	ander
Anderen.	ander
anders.	ander
Ands.	Andreas
ano.	anno
antjen.	Antje
appelen.	oranjeappel
aps.	UNRESOLVED
#arijansz.	Adriaansz
assuransie.	assurantie
avanseeren.	avanceren
B.Albinus	B._Albinus
Ballak.	Ballak
barsten.	barsten
Bartelmeeus.	Bartelmees
#Bartelmx.	Bartelmees
Basson.	basson
#basteiaensz.	Basteiaensz
Batavia.	Batavia
beantwoorden.	beantwoorden
beäntwoorden.	beantwoorden
beantwwoorden.	beantwoorden
bearbeijden.	bearbeiden
becenden.	bekende
Beck.	Van de Beck
becomen.	bekomen
becommen.	bekomen
bedanke.	bedanken
bedanken.	bedanken
bedeelen.	bedelen
bederven.	bederven
bediend.	bedienen
bedinen.	bedienen
bedorven.	bederven
bedraagt.	bedragen
bed.	UNRESOLVED
Beer.	Beer
beesigheeden.	bezigheid
beeter.	beter
befunden.	bevinden
begaan.	begaan
begaf.	begeven
begeeven.	begeven
begrypen.	begrijpen
behaagd.	behagen
Behaage.	behagen
behandelen.	behandelen
Behandigen.	behandigen
behertigen.	behartigen
behoede.	behoeden
behoeden.	behoeden
behoet.	behoeden
behoord.	behoren
beklagen.	beklagen
bekleet.	bekleden
bekomen.	bekomen
bekomt.	bekomen
beKoomen.	bekomen
belasten.)	belasten
beleeven.	beleven
belet.	beletten 
beleven.	beleven
belieft.	believen
belooft.	beloven
Beminde.	bemind
beminde.	beminde
beminden.	beminde
benen.	zijn
Bennelle.	Bennelle
benn..	zijn
ben.	zijn
Ben.	zijn
bepaalen.	bepalen
berigt.	bericht
berooft.	beroven
berrigten.	berichten
berüsten.	berusten
beschaadigt.	beschadigd
bescheijt.	bescheid
bescherminge.	bescherming
beschouwen.	beschouwen
beschouwt.	beschouwen 
beseert.	bezeren
besorgd.	bezorgen
besorgen.	bezorgen
besorgt.	bezorgen
beste.	best
bestelt.	voortbestellen
betaald.	betalen
betaalen.	betalen
betalen.	betalen
#bet.	betalen
betrouwen.	betrouwen
betuijge.	betuigen
betuijgen.	betuigen
betuygen.	betuigen
bevele.	aanbevelen
bevinde.	bevinden
bevinden.	bevinden
bevolen.	bevelen
bevonden.	bevinden
bewaardt.	bewaren
bewaaren.	bewaren
bewaert.	bewaren
beweesen.	bewijzen
bewerken.	bewerken
bewerkstelligen.	bewerkstelligen
bewijsen.	bewijzen
bewust.	bewust
Bezoeken.	bezoeken
bezorgen.	bezorgen
bidde.	bidden
blijve.	blijven
blijven.	blijven
bloem.	passiebloem
blycken.	blijken
Blydtschap.	blijdschap
blyven.	blijven
boek.	boek
boeken.	boeken
Boer.	De Boer
boer.	De Lachende Boer
boesemen.	inboezemen
Bolle.	Bolle
Bouense.	bovenst
Bourss.	Bourss
bo[..]ven	bovenal_de
bragt.	brengen
brengen.	bijbrengen
brengen.	brengen
brengen.	doorbrengen
brengen.	meebrengen
Breton.	Breton
brief.	brief
Briefwisseling.	briefwisseling
Brif.	brief
bringen.	brengen
broeder.	broeder
Broeder.	broeder
Broeders.	broeder
Broed.r	broeder
broers.	broer
broot.	brood
Bruno.	Bruno
Buijs.	Buijs
buitengemeen.	buitengemeen
buitenlandsche.	buitenlands
burchwal.	Burgwal
by.	erbij
byten.	bijten
Caap.	Kaap de Goede Hoop
Caatje.	Kaatje
Cadenski.	Cadenski
Calpettij.	Kalpitya
Canoos.	kano
Capelle.	Paravicini de Capelle - Van Woensel
Capiteyn.	kapitein
causeert.	causeren
Ceijlon.	Ceylon
Ceilon.	Ceylon
cent.	procent
chagrin.	chagrijn
China.	China
Chirurgijn.	chirurgijn
christen.	christen
christen=wijsgeer.	christen-wijsgeer
Clarinette.	klarinet
codro.	ringanty ilia codro
Coffy.	koffie
#cognossemt.	cognossement
collecteeren.	collecteren
comen.	komen
Commanduer.	commandeur
communicatie.	communicatie
communiceren.	communiceren
comporteert.	comporteren
confereren.	confereren 
consenteeren.	consenteren
conserveeren.	conserveren
Continu.	Continu
Continueeren.	continueren
continuveeren.	continueren
contribueeren.	contribueren
contribueert.	contribueren
Cooten.	Van Cooten
Copia.	copia
Cordes.	Cordes
couranten.	courant
Couvert.	couvert
couvert.	sous couvert
coverto.	couvert
crapeeren.	creperen
crediet.	krediet
Crijgen.	weerkrijgen
C.vander	C._Van der Vloten
daagen.	dag
daarna.	daarna
dag.	dag
Dag.	dag
dagelijks.	dagelijks
dagen.	dag
dagh.	dag
d.andre	de_ander
dankbaarheid.	dankbaarheid
danken.	danken
dat.	dat
Dat.	dat
dauid.	David
December.	december
decideren.	decideren
deel.	deel
deelen.	mededelen
dehaasz.	De Haasz
den.	de
Den.	de
denken.	denken
denkt.	denken
den.	worden
Déo.)	pro deo
dericsen.	Dericsen
dese.	deze
dezelve.	dezelve
dezes.	deze
dienaar.	dienaar
Dienaar.	dienaar
dien.	die
dienende.	dienen
dier[..]sse	UNRESOLVED
die[...]winie	UNRESOLVED
dit.	dit
ditto.	dito
Dochter.	dochter
doct.	dokter
doe.	doen
doe[..]gen	UNRESOLVED
doen.	doen
doen.	weldoen
Doeve.	Doeve
dood.	dood
doode.	dode
doodelijk.	dodelijk
doodt.	dood
doon.	doen
door.	hierdoor
doot.	dood
Doot.	dood
driege.	dreigen
Duclasel.	Duclasel
duister.	duister
duur.	duur
duyster.	duister
dwarsstraat.	Lange Leidsedwarsstraat
een.)	een
eerlicke.	eerlijk
Eerw.	eerwaarde
Eerw.	u_weleerwaarde
Eeuwig.	eeuwigheid
eeuwigheid.	eeuwigheid
Eeuwigheijt.	eeuwigheid
Egtgenoot.	echtgenoot
eijgen.	eigen
eijghen.	eigen
eijsen.	ijzen
Eilanden.	Canarische Eilanden
Elmersz.	Elmersen
Elmerts.	Elmersen
Elzie.	Elsje
ende.	en
en.	en
Engelant.	Engeland
Engelen.	engel
entameeren.	entameren
erken.	erkennen
erlangen.	erlangen
Estimeere.	estimeren
Eustasius.	Sint Eustatius
Eustasuis.	Sint Eustatius
Euwige.	eeuwig
Exceptie.	exceptie
exkuseeren.	excuseren
faaren.	varen
fleesch.	vlees
flo.	fl.
Focksz.	Focksz
franckrijk.	Frankrijk
Fransche.	Franse
fransinnite.	Fransientje
gaan.	gaan
gaan.	meegaan
gaan.	tegengaan
gaat.	gaan
gaen.	gaan
gaen.	welgaan
gaff.	geven
gals.	De Gals
Garnaades.	Granada
gaten.	gat
G.Blauw	G._Blauw
gearriveerd.	arriveren
gearriveerdt.	arriveren
gearriveert.	arriveren
Gearriveert.	arriveren
geavanceert.	avanceren
Gebesoigneerd.	besoigneren
gebeuren.	gebeuren
gebeurt.	gebeuren
gebleeven.	blijven
gebleven.	blijven
gebracht.	brengen
gebroken.	breken
gebueren.	gebuur
ge[...]cht	UNRESOLVED
geconfisqueert.	confisqueren
gecoomen.	komen
gedaan.	doen
gedaen.	doen
gedagten.	gedachte
gedeclint.	declineren
gedenken.	gedenken
gediendt.	dienen
gedienstige.	gedienstig
gedienstig.	gedienstig
gedraage.	gedragen
gedraagen.	gedragen
gedronken.	drinken
geduld.	geduld
geduurt.	duren
geeffectueerd.	effectueren
geeft.	geven
geeft.	uitgeven
geene.	hetgeen
geensins.	geenszins
geestelijck.	geestelijk
geeven.	geven
gegaan.	gaan
gegaen.	gaan
gegeeven.	meegeven
gegeven.	geven
gegeven.	wederomgeven
gegooyt.	gooien
gegroet.	groeten
gehad.	hebben
gehad.	plaatshebben 
gehadt.	hebben
gehouden.	afhouden
gehouden.	houden
gejammerd.	jammeren
gekogt.	kopen
gekomen.	bijkomen
gekomen.	binnenkomen
gekomen.	komen
gekoomen.	komen
gekreegen.	krijgen
gelaaten.	laten
geld.	geld
Geld.	geld
geleegen.	gelegen
geleezen.	lezen
gelegen.	liggen
Geleide.	geleiden
geleijde.	geleiden
geleijdt.	geleiden
gelevert.	leveren
geleyde.	geleiden
gelijde.	geleiden
geloovend.	hardgelovend
gelooven.	geloven
geloven.	geloven
gelt.	geld
gemaakt.	maken
gem.de	gemeld
genade.	genade
genadig.	genadig
genaemt.	genaamd
genagt.	genacht
genegentheid.	genegenheid
genieten.	genieten
geniet.	genieten
genoomen.	wegnemen
genoteerd.	noteren
geoffereert.	offreren
geordineert.	ordineren
gepasseerd.	passeren
geplukt.	plukken
geplundert.	uitplunderen
geracken.	voortgeraken
geraken.	geraken
geraken.	voortgeraken
gereesen.	rijzen
gerekent.	rekenen
gerendt.	renderen
gerestitueerd.	restitueren
geresumt.	resumeren
geretourneert.	retourneren
gereyst.	reizen
gesalutiert.	saluteren
geschieden.	geschieden
geschied.	geschieden
geschiedt.	geschieden
geschien.	geschieden
geschreeven.	schrijven
geschreuen.	schrijven
gescreven.	schrijven
geslagen.	slaan
gesleep.	inslepen
geslooten.	sluiten
gesonden.	toezenden
Gesonthyt.	gezondheid
gesorgd.	zorgen
Gesoundheijt.	gezondheid
Gespaar.	sparen
gespeelt.	spelen
gespoelt.	wegspoelen
gespoogen.	spugen
gesprongen.	springen
gestelt.	gesteld
gestoord.	gestoord
gestooten.	stoten
gestopt.	stoppen
gestorven.	sterven
gesundtheit.	gezondheid
getuijght.	getuigen
getuygen.	getuige
geuallen.	voorvallen
gevaar.	gevaar
gevallen.	vallen
geven.	geven
Gevers.	Gevers
gevlu[..]cht	vluchten
gevoelens.	gevoelen
gevonden.	vinden
gevraagt.	vragen
geweest.	zijn
Geweest.	zijn
geworden.	geworden
geworden.	worden
geworpen.	werpen
gezegt.	zeggen
gezicht.	gezicht
gezonden.	zenden
gezondheid.	gezondheid
gezondheijd.	gezondheid
gezongen.	zingen
gezont.	gezond
ghecomen.	komen
ghelucken.	gelukken
ginge.	gaan
goddelij[..]ken	goddelijk
godt.	God
Godt.	God
goed[..]e	goed
goed.	goed
Goed.	goed
goet.	goed
gorron.	UNRESOLVED
Gossling.	Gossling
gratie.	gratie
groeten.	groeten
groetenijse.	groetenis
groodt.	groot
Groot.	De Groot
groot.	groot
Guinea.	Guinee
gulden.	gulden
haast.	haast
hadde.	hebben
Haerlem.	Haarlem
haest.	haast
Haexwant.	Haexwant
Hage.	Den Haag
Haghswant.	Haghswant
Hamburgh.	Hamburg
Hamen.	Hamen
handigen.	overhandigen
hangt.	hangen
Hans.	Hans
hartelijk.	hartelijk
harten.	hart
hart.	hart
hart.	van_Het Vergulde Hart
hebbe.	hebben
hebbende.	hebben
hebben.	hebben
heb.	hebben
hebt.	hebben
heeft.	hebben
heeft.	voorhebben
heevenwell.	evenwel
Heide.	Heide
Heiden.	heiden
Heijden.	Heijden
heijl.	heil
helpen.	helpen
hem.	hij
Hendk.	Hendrik
Hend.r	Hendrik
Hendrick.	Hendrik
herhaald.	herhalen
herstelt.	herstellen
herten.	hart
hertgrond.	hartgrondig
hert.	hart
het.	het
Heusch.	Heusch sr.
Heyligdom.	heiligdom
hier.	hier
hier.	vanhier
hinderen.	verhinderen
h[..]loick	kloek
hobs.	Hobs
Hogagting.	hoogachting
Hol.g.gulds	Hollands_gulden
holland.	Holland
hollandt.	Holland
#holl.	Hollands
#Holls.	Hollands
#hollt.	Holland
#Hollt.	Holland
honderd.	driehonderd
hooffden.	hoofd
hoogachting.	hoogachting
hoogagting.	hoogachting
Hoogagting.	hoogachting
hoog.	hoog
Hoogmoogende.	hoogmogende
hoolij.	olie
hoope.	hopen
hooren.	horen
Hoorn.	Hoorn
Hopp.	Hopp
houden.	houden
houw.	houden
huewelijk.	huwelijk
Huijden...}	huid
huijsvrouw.	huisvrouw
huishoudster.	huishoudster
#huisom.)	UNRESOLVED
huisvrouw.	huisvrouw
hulp.	hulp
Humbert.	Humbert
huren.	huren
Huysen.	huis
hvij[.]s	Huis Iepenstein
illis.	Tempora mutantur et Nos mutamur in illis
incomoderen.	incommoderen
Indien.	Oost-Indië
ingenomen.	innemen
integendeel.	integendeel
int..	in_het
inwooninge.	inwoning
iouisseren.	jouïsseren
is.:	zijn
is.	zijn
jaaren.	jaar
jaar.	jaar
Jaar.	jaar
jaeren.	jaar
Jaspers.	Jaspers
J.Hogerwaard	J._Hogerwaard
Jnborst.	inborst
Jndia.	Indië
jngesetenen.	ingezetene
Jn.	inhebben
Jong.	De Jong
Jongens.	jongen
jongman.	jonkman
juffrouw.	juffrouw
Jureyaens.	Jurriaans
kaas.	kaas
kan.	kunnen
Kemper.	Kemper
kennen.	kennen
kennis.	kennis
Kerkstraat.	Kerkstraat
Kinderen.	Der Kinderen
kinderen.	kind
Kinderen.	kind
kind.	kind
kistje.	kist
klaagen.	klagen
klage.	klagen
koe.	Koe
Koert.	Koert
Kolombo.	Colombo
komen.	komen
komt.	komen
kon.	kunnen
koomen.	komen
koop.	koop
koopt.	kopen
kort.	kort
koud.	koud
kousen.	vrouwenkous
kraam.	kraam
kralen.	kraal
krijgen.	krijgen
krycht.	krijgen
kryge.	krijgen
krygen.	krijgen
K.schippert	K._Schippert
kunnen.	kunnen
kwaad.	kwaad
Laaden.	afladen
laaden.	laden
laaten.	laten
labor.	sed hoc opus hic labor
laden.	laden
laggen.	lachen
l.brief	brief
leege.	liggen
Leenen.	lenen
leeren.	leren
leert.	leren
leest.	lezen
leeven.	leven
leezen.	voorlezen
leggen.	leggen
legrand.	Le Grand
letteren.	letter
letterhout….18	letterhout_achttien
leuen.	leven
leven.	leven
Leven.	leven
libra..	libra
liefde.	liefde
Liefde.	liefde
lieff.	lief
lief.	lief
Lief.	lief
lief.	papalief
lieft.	lief
liepen.	lopen
liet.	laten
&liev.	en_lief
liev.	liefhebben
ligsgraave.	Ligsgraave
Lijcochtsen.	Lijcochtsen
lijden.	lijden
lijff.	lijf
Liuorno.	Livorno
Loff.	godlof
lof.	godlof
logeert.	logeren
logiment.	logement
Londen.	Londen
loopt.	tegenlopen
lossen.,	lossen
lucht.	lucht
Luitenant.	luitenant
lu[..]kes	Lukas
maaken.	gebruikmaken
maaken.	maken
maakt.	maken
maal.	ditmaal
maanden.	maand
maand.	maand
macken.	bekendmaken
maecken.	bekendmaken
maecken.	maken
maecken.	schoonmaken
maeij[...]strate	UNRESOLVED
maeke.denckt	maken_denken
maeke.	maken
maet.	maat
mag.	mogen
Mag.	mogen
maken.	maken
maken.	overmaken
malkanderen.	malkander
Man.	Kraijenhof - de Man
man.	man
Man.	man
Martins.	Sint Maarten
medebrenghen.	meebrengen
meel.	bollenmeel
meer.	meer
Mejufvrouw.	mejuffrouw
melde.	melden
melden.	melden
mensche.	mens
mensg.	mens
merken.	merken
middag.	middag
middelburg.	Middelburg
Middelburg.	Middelburg
Midelburge.	Middelburg
mij.	ik
mijn.	ik
mi[..]nne	mijn
minzaam[.]st	minzaam
missen.	missen
miste.	missen
moeder.	moeder
Moeder.	moeder
moet.	meemoeten
moet.	moeten
mogen.	mogen
Monfrere.	monfreer
monsieur.	monsieur
Monsieur.	monsieur
Moorlandt.	Immens wed. Moorlandt
morzelen.	morzel
Mundi.	Semper qui regnat omnia Mundi
naagels.	nagel
naam.	naam
naby.	nabij
Nacheng.	Nacheng
na.	daarna
Naek.	Naek
naer.	naar
nakomt.	nakomen
Napoli.</anders>	Napels
nasien.	nazien
natien.	natie
Nazareth.	nazaret
nederlant.	Nieuw-Nederland
Neef.)	neef
Neef.	neef
neemen.	meenemen
neemen.	nemen
neem.	waarnemen
Neev.	neef
Negers.	neger
nemen.	meenemen
nemen.	waarnemen
Nette.	net
neuhoff.	Neuhoff
Nicht.	nicht
niet.	niet
niet.	niets
nieuws.	nieuw
niewejaar.	nieuwjaar
Nigt.	nicht
nijuwenhuijs.	Nieuwenhuis
noemen.	noemen
noeme.	noemen
noemt.	noemen
nog.	nog
Noij.	Noij
oeffend.	oefenen
oeffenschoole.	De oeffenschoole
offeren.	opofferen
offresert.	offresseren
omarmen.	omarmen
om.	daarom
omhelzen.	omhelzen
om.	om
onbekend.	onbekend
onbekent.	onbekend
ondergaan.	ondergaan
onderhouden.	onderhouden
onderneemingen.	onderneming
onderrigten.	onderrichten
onderteekenen.	ondertekenen
ongerustheijd.	ongerustheid
onkunde.	onkunde
ons.	wij
ontbloot.	ontbloten
ontbreeken.	ontbreken
ontbreekt.	ontbreken
ontfangen.	ontvangen
Ontfangen.	ontvangen
ontgaen.	ontgaan
ontleent.	ontlenen
ontvangen.	ontvangen
ontwaarden.	ontwaren
ook.	ook
oolij.	olie
Oom.	oom
oordeelen.	oordelen
oorloch.	oorlog
Oorloog.	oorlog
ooverlegt.	overleggen
op.	daarop
opengesteld.	openstellen
op.	erop 
opgeeft.	opgeven
opgejaagt.	opjagen
opgemerkt.	opmerken
opgespannen.	opspannen
ophaalen.	ophalen
opneemen.	opnemen
op.	op
op.	opslaan
oppaszen.	oppassen
opschik.	opschik
optedraagen.	opdragen_te
ordoneert.	ordonneren
ordonneeren.	ordonneren
Origineel.	origineel
Ouders.	ouder
ouwels.	lakouwel
overga.	overgaan
overige.	overig
overkoomen.	overkomen
overleeden.	overlijden
Overleeden.	overlijden
over.	over
overtuiging.	overtuiging
paerden.	paard
Paijs.	Paijs
Papier.	papier
passeeren.	passeren
passeert.	passeren
passert.	passeren
passt.	passato
Pater.	pater
Patroon.	patroon
peeper.	peper
Pennen.	pen
persingen.	persing
Pieter.	Pieter
pire.	Du Pire
plaag.	plagen
pligtverzuim.	plichtverzuim
plukken.	plukken
plunderen.	plunderen
port.	port
Portugeeze.	Portugees
potten.	pot
producten.	product
proffiteert.	profiteren
Protexie.	protectie
prys.	prijs
quaadt.	kwaad
Quevulerius.	Quevulerius
raake.	kwijtraken 
raakt.	raken
Recieff.	recief
recomanderen.	recommanderen
recommandeeren.	recommanderen
Recommandeert.	recommanderen
recommandére.	recommanderen
recompenseren.	recompenseren
redelijck.	redelijk
reeds.	reeds
refereeren.	refereren
referrere.	refereren
Regaal.	regaal
reguleren.	reguleren
Remiteeren.	remitteren
Remitteeren.	remitteren
request.	rekwest
Residerende.	resideren
resief.	recief
Respect.	respect
Retouren.	retour
reusseeren.	reüsseren
revereeren.	refereren
rijckdom.	rijkdom
roep.	roepen
ross.	Ross
Ross.	Ross
Rout.	Rout
ruggedrijven.	terugdrijven
ruine.	ruïne
ruitjes.	ruitje
Rust.	Zorg en Rust
safraen.	saffraan
Sagtleeven.	Zagtleven
saligheijt.	zaligheid
saluijt.	saluut
sal.	zullen
Satyriecq.	satirisch
scheepen.	schip
scheepsgeleegentheid.	scheepsgelegenheid
schieden.	overschieten
schikken.	schikken
Schildt.	schild
schip.	schip
schorte.	schorten
schoute-bij-nacht.	schout-bij-nacht
schouwburg.	schouwburg
schrijuen.	schrijven
schrijven.	schrijven
schrijvens.	schrijven
schryven.	schrijven
Schryven.	schrijven
schuld.	schuld
seegeningen.	zegening
see.	zee
seggen.	zeggen
Seggen.	zeggen
seijt.	stadszijde
sein.	zijn
senden.	vooruitzenden
senden.	zenden
Senden.	zenden
september.	september
S.Eustatius	Sint Eustatius
sexe.	sekse
s.Hagen	\'s Gravenhage
sien.	zien
sijn.	zijn
Sijn.	zijn
sijt.	zijn
sij.	zijn
sindt.	zijn
Sinpaticeeren.	sympathiseren
slaan.	inslaan
slaan.	slaan
slaaven.	slaaf
slaven.	slaaf
slegt.	slecht
sluijs.	Maasluis
sluijten.	sluiten
smeeken.	smeken
Smissen.	Van der Smissen
Soek.	zoeken
solliciteeren.	solliciteren
Soomerkamp.	Soomerkamp
soon.	predikantszoon
sop.	limoensap
Spall.	Pieter_Gerrit_Van Spall
sparen.	sparen
Speelen.	spelen
Spiegeltjes.	toiletspiegeltje
spreeken.	spreken
spreken.	spreken
staad.	staan
staan.	bijstaan
staande.	staan
staan.	staan
staat.	staan
staen.	stilstaan
staet.	staan
steeg.	Huiszittensteeg
steert.	staart
stellen.	stellen
stellen.	uitstellen
sterken.	sterken
sterk.	sterk
Sterkte.	sterkte
sterven.	sterven
St.Eustats	Sint Eustatius
Steven.	Stephanus_Henricus_Cadenski
Stijl.N.	stijl_nieuw
stillen.	stillen
storten.	storten
Straaten.	straat
straat.	Kalverstraat
Straet.	Straat
straffen.	straffen
strecken.	strekken
strecke.	strekken
strekke.	strekken
stucken.	stuk
stuijten.	stuiten
stuv.	stuiver
stuyvers.	stuiver
Susters.	zuster
suster.	zuster
Suster.	zuster
swager.	zwager
swarigheden.	zwarigheid
syn.	zijn
syt.	zijn
sy.	zijn
taak.	taak
Tabak.	tabak
Tante.	tante
teegendeel.	integendeel
teekenende.	tekenen
teekenen.	tekenen
tegenwoordigh.	tegenwoordig
telijden.	te_lijden
Temmink.	Temmink
tenemen.	waarnemen_te
Terre.	Capesterre-Belle-Eau
Texel.	Texel
t.Heelal	het_heelal
t’huijs.	thuis
thuijs.	thuis
tijdelijck.	tijdelijk
tijding.	tijding
tijd.	tijd
tijdt.	tijd
t’leeren.	het_leren
toeback.	tabak
toecoomen.	toekomen
toegaat.	toegaan
toegeneegentheid.	toegenegenheid
toegenoomen.	toenemen
toegeslooten.	toesluiten
toejuijching.	toejuiching
toekomen.	toekomen
toepassen.	toepassen
toetezenden.	toezenden_te
toe.	toelaten
toe.	toezien
toevertrouwen.	toevertrouwen
toewensen.	toewensen
toewenst.	toewensen
toonen.	tonen
tot.	tot
&tra.	et cetera
treffen.	aantreffen
troosten.	troosten
trouwen.	trouwen
t.wilde	Het Wilde Varken
tyd.	tijd
Uede.	u_edele
uijt.	achteruitteren
uijtgieten.	uitgieten
uitgezeijlt.	uitzeilen
uitkomst.	uitkomst
uitslag.	uitslag
utrecht.	Stad Utrecht
uure.	uur
uwent.	uwent
uytlandig.	uitlandig
uytvoeren.	uitvoeren
vaamen.	vadem
vaarende.	welvarend
Vaaren.	varen
vaart.	varen
vaarwel.	vaarwelzeggen
vader[...]en	vader_UNRESOLVED
vaderlants.	vaderland
vader.	vader
Vader.	vader
Vaeder.	vader
vaeten.	vat
Valete.	valete
Vale.	vale
vandroefheid.	van_droefheid
vand.r	Van der S.
van.	van
varen.	varen
V.E.onderdanige	ue._onderdanig
vera.	cortex peruviani vera
verandert.	veranderen
verantwoorden.	verantwoorden
Verbeetert.	verbeteren
verblijven.	verblijven
verblyve.	verblijven
Vercoopreeck.	verkooprekening
verdienen.	verdienen
verdient.,	verdienen
verdraagen.	verdragen
verdr[..]t	verdrieten
verd.t	verdriet
vergaan.	vergaan
vergaen.	vergaan
vergeeten.	vergeten
verGeeten.	vergeten
vergelden.	vergelden
vergenoegt.	vergenoegd
vergoeden.	vergoeden
Verheugen.	verheugen
verhuijren.	verhuren
verkeere.	verkeren
verkoopen.	verkopen
Verkoopen.	verkopen
verkoopt.	verkopen
verlaaten.	verlaten
verlangde.	verlangen
verleenen.	verlenen
Verleenen.	verlenen
verliesen.	verliezen
Verlooren.	verliezen
vermeldt.	vermelden
vermindert.	verminderen
verneemen.	vernemen
vernemen.-	vernemen
vernemen.	vernemen
vernoeging.	vernoeging
vernomen.	vernemen
Veroorsaeken.	veroorzaken
verpligten.	verplichten
verschaften.	verschaffen
Verschoonen.	verschonen
verschrijven.	verschrijven
verseeckert.	verzekeren
versien.	verzien
versoeke.	verzoeken
versorgen.	verzorgen
verstaen.	verstaan
verstrekt.	verstrekken
vertrekken.	vertrekken
vertrekke.	vertrekken
vertrekt.	vertrekken
vertrock.	vertrekken
vertrokken.	vertrekken
vertroost.	vertroosten
vervolg.	vervolg
vervuld.	vervullen
vervullen.	vervullen
vervulle.	vervullen
verwachte.	verwachten
verwagt.	verwachten
verzaken.	verzaken
verZeekeren.	verzekeren
Verzending.	verzending
verzoekenden.	verzoeken
verzoeken.	verzoeken
verzonden.	verzenden
vet.	vet
vierendeel.	vierendeel
vinden.	vinden
Vinden.	vinden
vlooypapier.	vloeipapier
voedende.	voeden
voegen.	voegen
voetsoekers.	voetzoeker
voldoen.	voldoen
volgen.	volgen
volgt..-	volgen
volkomen.	volkomen
volkryk.	volkrijk
voorbede.	voorbede
voorbij.	voorbijlaten
vooren.	voren
Voorgaande.	voorgaand
voorgeleezen.	voorlezen
voorgelezen.	voorlezen
voorgevallen.	voorvallen
voorsienigheid.	voorzienigheid
voorsin.	voorzien
voort.	voortbrengen
voort.	voortkomen
voorvallen.	voorvallen
vraagd.	vragen
vraagen.	vragen
vreden.	vrede
Vrede.	vrede
vrienden.	vriend
Vriendin.	vriendin
vriendschap.	vriendschap
vrije.	vrij
vrind.	vriend
vrintschap.	vriendschap
vrou.	vrouw
vrouw.	vrouw
Vrouw.	vrouw
Vrrenden.	vriend
vrugteloos.	vruchteloos
vrywillige.	vrijwillige
vullen.	vullen
waaks.	waak
waakt.	waken
waard.	waard
waaren.	zijn
Waarheijd.	waarheid
waar.	waarnemen
waar.	zijn
waater.	water
waert.	zijn
waer.	waar
wagten.	wachten
Wall.	wal
Walraven.	Walraven
Wardt.	waard
waren.	zijn
wassen.	wassen
wass.	zijn
was.	UNRESOLVED
was.	zijn
Water-stroomen.	waterstroom
wedergekeert.	wederkeren
Weders.	weder
weer.	we(d)erschrijven
weesen.	zijn
Weesen.	zijn
weeten.	weten
weezen.	zijn
weg.	weg
wegzinken.	wegzinken
weinig.	weinig
welbehaaglijk.	welbehaaglijk
weldoen.	weldoen
welgemaackt.	UNRESOLVED
welsijn.	welzijn
wel.	wel
wel.	welgaan
wel.	welvaren
wenschende.	wensen
wenscht.	toewensen
wensschen.	wensen
werden.	worden
werken.	uitwerken
werpen.	neerwerpen
wesen.	wezen
weten.	weten
wezen.	wezen
wierde.	worden
wierd.	worden
wijn.	wijn
wild.	willen
willigen.	te_inwilligen
Will.	willen
wil.	willen
Winnen.	winnen
Winter.	Winter
wint.	wind
wit.	De Wit
Witte.	Witte
Woensel.	Paravicini de Capelle - Van Woensel
Wolff.	Van der Wolff tot Swol
wollen.	wollen
won.	winnen
woonaghtich.	woonachtig
woonden.	wonen
woonen.	inwonen
woonen.	wonen
woone.	wonen
worden..	worden
worden.	worden
Worden.	worden
wou.	willen
wyn.	wijn
zag.	zien
zakgeld.	zakgeld
Zaligheid.	zaligheid
zalmelden.	zullen_melden
zal.	zullen
Zedt.	sedert
zee.	Egmond aan Zee
zeelandt.	Zeeland
zee.	zee
zeggen.	zeggen
zegge.	zeggen
zeijlen.	zeilen
zelvde.	dezelfde
Zelve.	dezelve
zenden.	zenden
ziektens.	ziekte
ziekte.	venusziekte
zielle.	ziel
zien.	aanzien
zien.	zien
Zien.	zien
ziet.	zien
zijnde.	zijn
zijn.	zijn
Zijn.	zijn
zijt.	zijn
zitten.	zitten
zoeken.	zoeken
zoons.	zoon
zoon.	zoon
Zoon.	zoon
zoo.	zo
zorgen.	zorgen
zoude.	zullen
zou.	zullen
zullen.	zullen
zult.	zullen
Zuster.	zuster
zwagerin.	zwagerin
zyn..	zijn
zyn.	zijn
 Stötzer.	Stötzer
