TTpos	CQL	head	voorbeeld
ADJ ADJ ADJ N	[ pos = "ADJ" ] [ pos = "ADJ" ] [ pos = "ADJ" ] [ pos = "NOUN" ]	3	onafhankelijk europes openbADJr ADJnklager
ADJ ADJ N	[ pos = "ADJ" ] [ pos = "ADJ" ] [ pos = "NOUN" ]	2	federale gerechtelijke politie
ADJ N	[ pos = "ADJ" ] [ pos = "NOUN" ]	1	administratief onderzoek
ADJ N ADJ N	[ pos = "ADJ" ] [ pos = "NOUN" ][ pos = "ADJ" ] [ pos = "NOUN" ]	1	ander oorzADJk bovenstADJnd probleem
ADJ NAME	[ pos = "ADJ" ] [ pos = "PROPN" ]	1	Corrupt Practices
ADJ N N	[ pos = "ADJ" ] [ pos = "NOUN" ] [ pos = "NOUN" ]	1	Federale Overheidsdienst Justitie
ADJ N NAME	[ pos = "ADJ" ] [ pos = "NOUN" ] [ pos = "PROPN" ]	1	internationale werkgeversorganisatie ICC
ADJ N NAME NAME	[ pos = "ADJ" ] [ pos = "NOUN" ] [ pos = "PROPN" ] [ pos = "PROPN" ]	1	Federale Politie CDBC Police
ADJ N VZ N	[ pos = "ADJ" ] [ pos = "NOUN" ] [ pos = "ADP" ] [ pos = "NOUN" ]	1	Europees Bureau voor fraudebestrijding
ADJ N VZ NAME	[ pos = "ADJ" ] [ pos = "NOUN" ] [ pos = "ADP" ] [ pos = "PROPN" ]	1	Belgische afdeling van Transparency
N	[ pos = "NOUN" ]	0	ADJnhoudingsbevel
N ADJ ADJ N	[ pos = "NOUN" ] [ pos = "ADJ" ] [ pos = "ADJ" ] [ pos = "NOUN" ]	0	Parlement beschikbADJr gestelde middelen
N ADJ N	[ pos = "NOUN" ] [ pos = "ADJ" ] [ pos = "NOUN" ]	0	Commissie constitutionele zaken
N ADJ N NAME	[ pos = "NOUN" ] [ pos = "ADJ" ] [ pos = "NOUN" ] [ pos = "PROPN" ]	0	Justitie Federale Politie CDBC
NAME	[ pos = "PROPN" ]	0	ABM
NAME ADJ NAME	[ pos = "PROPN" ][ pos = "ADJ" ] [ pos = "PROPN" ]	2	foreign corrupt practices
NAME N	[ pos = "PROPN" ] [ pos = "NOUN" ]	0	fod financiën
NAME N ADJ N	[ pos = "PROPN" ] [ pos = "NOUN" ] [ pos = "ADJ" ] [ pos = "NOUN" ]	0	fod justitie federADJl politie
NAME NAME	[ pos = "PROPN" ] [ pos = "PROPN" ]	1	grand prix
NAME NAME ADJ N	[ pos = "PROPN" ] [ pos = "PROPN" ][ pos = "ADJ" ] [ pos = "NOUN" ]	3	transparency international opgesteld index
NAME NAME N	[ pos = "PROPN" ] [ pos = "PROPN" ] [ pos = "NOUN" ]	2	greco oeso vn-corruptie
NAME NAME NAME	[ pos = "PROPN" ] [ pos = "PROPN" ] [ pos = "PROPN" ]	2	united nations convention
NAME NAME NAME N	[ pos = "PROPN" ] [ pos = "PROPN" ] [ pos = "PROPN" ] [ pos = "NOUN" ]	3	portal greco oeso vn-corruptie
NAME NAME N N	[ pos = "PROPN" ] [ pos = "PROPN" ] [ pos = "NOUN" ] [ pos = "NOUN" ]	3	greco oeso vn-corruptie gedragscode
NAME NAME VZ N	[ pos = "PROPN" ] [ pos = "PROPN" ] [ pos = "ADP" ] [ pos = "NOUN" ]	3	verenigde naties tegen corruptie
NAME N N	[ pos = "PROPN" ] [ pos = "NOUN" ] [ pos = "NOUN" ]	2	oeso vn-corruptie gedragscode
NAME N NAME	[ pos = "PROPN" ] [ pos = "NOUN" ] [ pos = "PROPN" ]	1	fod financiën icc
NAME VZ LID N	[ pos = "PROPN" ] [ pos = "ADP" ] [ pos = "pd" ] [ pos = "NOUN" ]	3	oren in de nek
NAME VZ N	[ pos = "PROPN" ] [ pos = "ADP" ] [ pos = "NOUN" ]	2	werkpirouette in stap
NAME VZ NAME	[ pos = "PROPN" ] [ pos = "ADP" ] [ pos = "PROPN" ]	2	irak van saddam
NAME VZ NAME NAME	[ pos = "PROPN" ] [ pos = "ADP" ] [ pos = "PROPN" ] [ pos = "PROPN" ]	3	irak van saddam hussein
N N	[ pos = "NOUN" ] [ pos = "NOUN" ]	1	besluit akte
N NAME	[ pos = "NOUN" ] [ pos = "PROPN" ]	0	bondsrepubliek duitsland
N NAME N	[ pos = "NOUN" ] [ pos = "PROPN" ] [ pos = "NOUN" ]	2	web fod begroting
N NAME NAME	[ pos = "NOUN" ] [ pos = "PROPN" ] [ pos = "PROPN" ]	0	grootmeester françois robichon
N NAME NAME NAME	[ pos = "NOUN" ] [ pos = "PROPN" ] [ pos = "PROPN" ] [ pos = "PROPN" ]	0	internet portal greco oeso
N NAME VZ N	[ pos = "NOUN" ] [ pos = "PROPN" ] [ pos = "ADP" ] [ pos = "NOUN" ]	0	ADJnspring telgang in stap
N N N	[ pos = "NOUN" ] [ pos = "NOUN" ] [ pos = "NOUN" ]	2	hoofd tandenknars tong
N N NAME	[ pos = "NOUN" ] [ pos = "NOUN" ] [ pos = "PROPN" ]	1	bedrijfsleven voorwoord belgië
N N NAME NAME	[ pos = "NOUN" ] [ pos = "NOUN" ] [ pos = "PROPN" ] [ pos = "PROPN" ]	1	wereldbank internet portal greco
N N VZ N	[ pos = "NOUN" ] [ pos = "NOUN" ] [ pos = "ADP" ] [ pos = "NOUN" ]	1	pirouette keertwending in stap
N VZ ADJ N	[ pos = "NOUN" ] [ pos = "ADP" ] [ pos = "ADJ" ]  [ pos = "NOUN" ]	0	beginsel van dubbel controle
N VZ LID N	[ pos = "NOUN" ] [ pos = "ADP" ] [ pos = "pd" ] [ pos = "NOUN" ]	0	akte van de rADJd
N VZ LID NAME	[ pos = "NOUN" ] [ pos = "ADP" ] [ pos = "pd" ] [ pos = "PROPN" ]	0	vergadering van de vn
N VZ N	[ pos = "NOUN" ] [ pos = "ADP" ] [ pos = "NOUN" ]	0	ADJnsprakelijkheid van rechtspersoon
N VZ NAME	[ pos = "NOUN" ] [ pos = "ADP" ] [ pos = "PROPN" ]	0	rADJd van europa
N VZ NAME NAME	[ pos = "NOUN" ] [ pos = "ADP" ] [ pos = "PROPN" ] [ pos = "PROPN" ]	0	afdeling van transparency international
N VZ N N	[ pos = "NOUN" ] [ pos = "ADP" ] [ pos = "NOUN" ] [ pos = "NOUN" ]	0	middel van smeergeld bescherming
