ADJ(dial)	AA(degree=uncl,position=uncl)
ADJ(nom,basis,met-e,mv-n)	NOU-C(number=pl)
ADJ(nom,basis,met-e,zonder-n,bijz)	NOU-C(number=sg)
ADJ(nom,basis,met-e,zonder-n,stan)	NOU-C(number=sg)
ADJ(nom,basis,zonder,mv-n)	NOU-C(number=pl)
ADJ(nom,basis,zonder,zonder-n)	NOU-C(number=sg)
ADJ(nom,comp,met-e,mv-n)	NOU-C(number=pl)
ADJ(nom,comp,met-e,zonder-n,bijz)	NOU-C(number=sg)
ADJ(nom,comp,met-e,zonder-n,stan)	NOU-C(number=sg)
ADJ(nom,comp,zonder,zonder-n)	NOU-C(number=sg)
ADJ(nom,sup,met-e,mv-n)	NOU-C(number=pl)
ADJ(nom,sup,met-e,zonder-n,bijz)	NOU-C(number=sg)
ADJ(nom,sup,met-e,zonder-n,stan)	NOU-C(number=sg)
ADJ(nom,sup,zonder,zonder-n)	NOU-C(number=sg)
ADJ(postnom,basis,met-s)	NOU-C(number=sg)
ADJ(postnom,basis,zonder)	AA(degree=pos,position=postnom)
ADJ(postnom,comp,met-s)	NOU-C(number=sg)
ADJ(postnom,comp,zonder)	AA(degree=comp,position=postnom)
ADJ(prenom,basis,met-e,bijz)	AA(degree=pos,position=prenom)
ADJ(prenom,basis,met-e,stan)	AA(degree=pos,position=prenom)
ADJ(prenom,basis,zonder)	AA(degree=pos,position=prenom)
ADJ(prenom,comp,met-e,bijz)	AA(degree=comp,position=prenom)
ADJ(prenom,comp,met-e,stan)	AA(degree=comp,position=prenom)
ADJ(prenom,comp,zonder)	AA(degree=comp,position=prenom)
ADJ(prenom,sup,met-e,bijz)	AA(degree=sup,position=prenom)
ADJ(prenom,sup,met-e,stan)	AA(degree=sup,position=prenom)
ADJ(prenom,sup,zonder)	AA(degree=sup,position=prenom)
ADJ(vrij,basis,zonder)	AA(degree=pos,position=free)
ADJ(vrij,comp,zonder)	AA(degree=comp,position=free)
ADJ(vrij,dim,zonder)	AA(degree=pos,position=free)
ADJ(vrij,sup,zonder)	AA(degree=sup,position=free)
BW()	ADV(type=uncl)
BW(dial)	ADV(type=uncl)
LET()	PC()
LID(bep,dat,evf)	PD(type=dem,subtype=art,position=prenom)
LID(bep,dat,evmo)	PD(type=dem,subtype=art,position=prenom)
LID(bep,dat,mv)	PD(type=dem,subtype=art,position=prenom)
LID(bep,dial)	PD(type=dem,subtype=art,position=prenom)
LID(bep,gen,evmo)	PD(type=dem,subtype=art,position=prenom)
LID(bep,gen,rest3)	PD(type=dem,subtype=art,position=prenom)
LID(bep,stan,evon)	PD(type=dem,subtype=art,position=prenom)
LID(bep,stan,rest)	PD(type=dem,subtype=art,position=prenom)
LID(onbep,dial)	PD(type=indef,subtype=art,position=prenom)
LID(onbep,gen,evf)	PD(type=indef,subtype=art,position=prenom)
LID(onbep,stan,agr)	PD(type=indef,subtype=art,position=prenom)
N(eigen,dial)	NOU-P()
N(eigen,ev,basis,dat)	NOU-P()
N(eigen,ev,basis,gen)	NOU-P()
N(eigen,ev,basis,genus,stan)	NOU-P()
N(eigen,ev,basis,onz,stan)	NOU-P()
N(eigen,ev,basis,zijd,stan)	NOU-P()
N(eigen,ev,dim,gen)	NOU-P()
N(eigen,ev,dim,onz,stan)	NOU-P()
N(eigen,mv,basis)	NOU-P()
N(eigen,mv,dim)	NOU-P()
N(soort,dial)	NOU-C(number=uncl)
N(soort,ev,basis,dat)	NOU-C(number=sg)
N(soort,ev,basis,gen)	NOU-C(number=sg)
N(soort,ev,basis,genus,stan)	NOU-C(number=sg)
N(soort,ev,basis,onz,stan)	NOU-C(number=sg)
N(soort,ev,basis,zijd,stan)	NOU-C(number=sg)
N(soort,ev,dim,gen)	NOU-C(number=sg)
N(soort,ev,dim,onz,stan)	NOU-C(number=sg)
N(soort,mv,basis)	NOU-C(number=pl)
N(soort,mv,dim)	NOU-C(number=pl)
SPEC(achter)	RM()
SPEC(afgebr)	RES(type=uncl,WF=trunc)
SPEC(afk)	RES(type=oth,WF=abbr)
SPEC(comment)	RM()
SPEC(deeleigen)	NOU-P()
SPEC(meta)	RES(type=meta)
SPEC(onverst)	RES(type=uncl)
SPEC(symb)	RES(type=symb)
SPEC(vreemd)	RES(type=for)
TSW()	INT()
TSW(dial)	INT()
TW(hoofd,dial)	NUM(type=card,position=uncl,representation=uncl)
TW(hoofd,nom,mv-n,basis)	NUM(type=card,position=free,representation=uncl)
TW(hoofd,nom,mv-n,dim)	NUM(type=card,position=free,representation=uncl)
TW(hoofd,nom,zonder-n,basis)	NUM(type=card,position=free,representation=uncl)
TW(hoofd,nom,zonder-n,dim)	NUM(type=card,position=free,representation=uncl)
TW(hoofd,prenom,bijz)	NUM(type=card,position=prenom,representation=uncl)
TW(hoofd,prenom,stan)	NUM(type=card,position=prenom,representation=uncl)
TW(hoofd,vrij)	NUM(type=card,position=prenom|postnom|free,representation=uncl)
TW(rang,dial)	NUM(type=ord,position=uncl,representation=uncl)
TW(rang,nom,mv-n)	NOU-C(number=pl)
TW(rang,nom,zonder-n)	NUM(type=ord,position=free,representation=uncl)
TW(rang,nom,zonder-n)[1]	NOU-C(number=sg)
TW(rang,prenom,bijz)	NUM(type=ord,position=prenom,representation=uncl)
TW(rang,prenom,stan)	NUM(type=ord,position=prenom,representation=uncl)
VG(neven)	CONJ(type=coor)
VG(onder)	CONJ(type=sub)
VG(onder,dial)	CONJ(type=sub)
VNW(aanw,adv-pron,obl,vol,3o,getal)	ADV(type=uncl)
VNW(aanw,adv-pron,stan,red,3,getal)	ADV(type=uncl)
VNW(aanw,det,dat,nom,met-e,zonder-n)	PD(type=dem,position=free)
VNW(aanw,det,dat,prenom,met-e,evf)	PD(type=dem,subtype=oth,position=prenom)
VNW(aanw,det,dat,prenom,met-e,evmo)	PD(type=dem,subtype=oth,position=prenom)
VNW(aanw,det,dial)	PD(type=dem,subtype=uncl,position=uncl)
VNW(aanw,det,gen,nom,met-e,zonder-n)	PD(type=dem,position=free)
VNW(aanw,det,gen,prenom,met-e,rest3)	PD(type=dem,subtype=oth,position=prenom)
VNW(aanw,det,stan,nom,met-e,mv-n)	PD(type=dem,position=free)
VNW(aanw,det,stan,nom,met-e,zonder-n)	PD(type=dem,position=free)
VNW(aanw,det,stan,prenom,met-e,rest)	PD(type=dem,subtype=oth,position=prenom)
VNW(aanw,det,stan,prenom,zonder,agr)	PD(type=dem,subtype=oth,position=prenom)
VNW(aanw,det,stan,prenom,zonder,evon)	PD(type=dem,subtype=oth,position=prenom)
VNW(aanw,det,stan,prenom,zonder,rest)	PD(type=dem,subtype=oth,position=prenom)
VNW(aanw,det,stan,vrij,zonder)	PD(type=dem,position=free)
VNW(aanw,pron,dial)	PD(type=dem,position=free)
VNW(aanw,pron,gen,vol,3m,ev)	PD(type=dem,position=free)
VNW(aanw,pron,gen,vol,3o,ev)	PD(type=dem,position=free)
VNW(aanw,pron,stan,nadr,3o,ev)	PD(type=dem,position=free)
VNW(aanw,pron,stan,vol,3,getal)	PD(type=dem,position=free)
VNW(aanw,pron,stan,vol,3o,ev)	PD(type=dem,position=free)
VNW(betr,det,dial)	PD(type=rel,position=free)
VNW(betr,det,stan,nom,met-e,zonder-n)	PD(type=rel,position=free)
VNW(betr,det,stan,nom,zonder,zonder-n)	PD(type=rel,position=free)
VNW(betr,pron,dial)	PD(type=rel,position=free)
VNW(betr,pron,gen,vol,3o,ev)	PD(type=rel,position=free)
VNW(betr,pron,gen,vol,3o,getal)	PD(type=rel,position=free)
VNW(betr,pron,stan,vol,3,ev)	PD(type=rel,position=free)
VNW(betr,pron,stan,vol,persoon,getal)	PD(type=rel,position=free)
VNW(bez,det,dat,vol,1,ev,nom,met-e,zonder-n)	NOU-C(number=sg)
VNW(bez,det,dat,vol,1,ev,prenom,met-e,evf)	PD(type=poss,position=prenom)
VNW(bez,det,dat,vol,1,ev,prenom,met-e,evmo)	PD(type=poss,position=prenom)
VNW(bez,det,dat,vol,1,mv,nom,met-e,zonder-n)	NOU-C(number=sg)
VNW(bez,det,dat,vol,1,mv,prenom,met-e,evf)	PD(type=poss,position=prenom)
VNW(bez,det,dat,vol,1,mv,prenom,met-e,evmo)	PD(type=poss,position=prenom)
VNW(bez,det,dat,vol,2,getal,nom,met-e,zonder-n)	NOU-C(number=sg)
VNW(bez,det,dat,vol,2,getal,prenom,met-e,evf)	PD(type=poss,position=prenom)
VNW(bez,det,dat,vol,2,getal,prenom,met-e,evmo)	PD(type=poss,position=prenom)
VNW(bez,det,dat,vol,2v,ev,prenom,met-e,evf)	PD(type=poss,position=prenom)
VNW(bez,det,dat,vol,3,ev,prenom,met-e,evf)	PD(type=poss,position=prenom)
VNW(bez,det,dat,vol,3,ev,prenom,met-e,evmo)	PD(type=poss,position=prenom)
VNW(bez,det,dat,vol,3m,ev,nom,met-e,zonder-n)	NOU-C(number=sg)
VNW(bez,det,dat,vol,3p,mv,nom,met-e,zonder-n)	NOU-C(number=sg)
VNW(bez,det,dat,vol,3p,mv,prenom,met-e,evf)	PD(type=poss,position=prenom)
VNW(bez,det,dat,vol,3p,mv,prenom,met-e,evmo)	PD(type=poss,position=prenom)
VNW(bez,det,dat,vol,3v,ev,nom,met-e,zonder-n)	NOU-C(number=sg)
VNW(bez,det,dat,vol,3v,ev,prenom,met-e,evf)	PD(type=poss,position=prenom)
VNW(bez,det,dat,vol,3v,ev,prenom,met-e,evmo)	PD(type=poss,position=prenom)
VNW(bez,det,dial)	PD(type=poss,position=prenom)
VNW(bez,det,gen,vol,1,ev,prenom,met-e,rest3)	PD(type=poss,position=prenom)
VNW(bez,det,gen,vol,1,ev,prenom,zonder,evmo)	PD(type=poss,position=prenom)
VNW(bez,det,gen,vol,1,mv,prenom,met-e,evmo)	PD(type=poss,position=prenom)
VNW(bez,det,gen,vol,1,mv,prenom,met-e,rest3)	PD(type=poss,position=prenom)
VNW(bez,det,gen,vol,2,getal,prenom,met-e,rest3)	PD(type=poss,position=prenom)
VNW(bez,det,gen,vol,2,getal,prenom,zonder,evmo)	PD(type=poss,position=prenom)
VNW(bez,det,gen,vol,2v,ev,prenom,met-e,rest3)	PD(type=poss,position=prenom)
VNW(bez,det,gen,vol,3,ev,prenom,met-e,rest3)	PD(type=poss,position=prenom)
VNW(bez,det,gen,vol,3,ev,prenom,zonder,evmo)	PD(type=poss,position=prenom)
VNW(bez,det,gen,vol,3p,mv,prenom,met-e,rest3)	PD(type=poss,position=prenom)
VNW(bez,det,gen,vol,3p,mv,prenom,zonder,evmo)	PD(type=poss,position=prenom)
VNW(bez,det,gen,vol,3v,ev,prenom,met-e,rest3)	PD(type=poss,position=prenom)
VNW(bez,det,gen,vol,3v,ev,prenom,zonder,evmo)	PD(type=poss,position=prenom)
VNW(bez,det,stan,nadr,2v,mv,prenom,zonder,agr)	PD(type=poss,position=prenom)
VNW(bez,det,stan,red,1,ev,prenom,zonder,agr)	PD(type=poss,position=prenom)
VNW(bez,det,stan,red,2v,ev,prenom,zonder,agr)	PD(type=poss,position=prenom)
VNW(bez,det,stan,red,3,ev,prenom,zonder,agr)	PD(type=poss,position=prenom)
VNW(bez,det,stan,red,3,getal,prenom,zonder,agr)	PD(type=poss,position=prenom)
VNW(bez,det,stan,vol,1,ev,nom,met-e,mv-n)	NOU-C(number=pl)
VNW(bez,det,stan,vol,1,ev,nom,met-e,zonder-n)	NOU-C(number=sg)
VNW(bez,det,stan,vol,1,ev,prenom,met-e,rest)	PD(type=poss,position=prenom)
VNW(bez,det,stan,vol,1,ev,prenom,zonder,agr)	PD(type=poss,position=prenom)
VNW(bez,det,stan,vol,1,mv,nom,met-e,mv-n)	NOU-C(number=pl)
VNW(bez,det,stan,vol,1,mv,nom,met-e,zonder-n)	NOU-C(number=sg)
VNW(bez,det,stan,vol,1,mv,prenom,met-e,rest)	PD(type=poss,position=prenom)
VNW(bez,det,stan,vol,1,mv,prenom,zonder,evon)	PD(type=poss,position=prenom)
VNW(bez,det,stan,vol,2,getal,nom,met-e,mv-n)	NOU-C(number=pl)
VNW(bez,det,stan,vol,2,getal,nom,met-e,zonder-n)	NOU-C(number=sg)
VNW(bez,det,stan,vol,2,getal,prenom,met-e,rest)	PD(type=poss,position=prenom)
VNW(bez,det,stan,vol,2,getal,prenom,zonder,agr)	PD(type=poss,position=prenom)
VNW(bez,det,stan,vol,2v,ev,nom,met-e,mv-n)	NOU-C(number=pl)
VNW(bez,det,stan,vol,2v,ev,nom,met-e,zonder-n)	NOU-C(number=sg)
VNW(bez,det,stan,vol,2v,ev,prenom,zonder,agr)	PD(type=poss,position=prenom)
VNW(bez,det,stan,vol,3,ev,prenom,zonder,agr)	PD(type=poss,position=prenom)
VNW(bez,det,stan,vol,3,mv,prenom,zonder,agr)	PD(type=poss,position=prenom)
VNW(bez,det,stan,vol,3m,ev,nom,met-e,mv-n)	NOU-C(number=pl)
VNW(bez,det,stan,vol,3m,ev,nom,met-e,zonder-n)	NOU-C(number=sg)
VNW(bez,det,stan,vol,3m,ev,prenom,met-e,rest)	PD(type=poss,position=prenom)
VNW(bez,det,stan,vol,3p,mv,nom,met-e,mv-n)	NOU-C(number=pl)
VNW(bez,det,stan,vol,3p,mv,nom,met-e,zonder-n)	NOU-C(number=sg)
VNW(bez,det,stan,vol,3p,mv,prenom,met-e,rest)	PD(type=poss,position=prenom)
VNW(bez,det,stan,vol,3v,ev,nom,met-e,mv-n)	NOU-C(number=pl)
VNW(bez,det,stan,vol,3v,ev,nom,met-e,zonder-n)	NOU-C(number=sg)
VNW(bez,det,stan,vol,3v,ev,prenom,met-e,rest)	PD(type=poss,position=prenom)
VNW(excl,det,stan,vrij,zonder)	PD(type=excl,position=free)
VNW(excl,pron,stan,vol,3,getal)	PD(type=excl,position=free)
VNW(onbep,adv-pron,gen,red,3,getal)	PD(type=pers,position=free)
VNW(onbep,adv-pron,obl,vol,3o,getal)	ADV(type=reg)
VNW(onbep,det,dat,prenom,met-e,evf)	PD(type=indef,subtype=oth,position=prenom)
VNW(onbep,det,dat,prenom,met-e,evmo)	PD(type=indef,subtype=oth,position=prenom)
VNW(onbep,det,dial)	PD(type=indef,subtype=uncl,position=uncl)
VNW(onbep,det,gen,nom,met-e,mv-n)	PD(type=indef,position=free)
VNW(onbep,det,gen,prenom,met-e,mv)	PD(type=indef,subtype=oth,position=prenom)
VNW(onbep,det,stan,nom,met-e,mv-n)	PD(type=indef,position=free)
VNW(onbep,det,stan,nom,met-e,zonder-n)	NOU-C(number=sg)
VNW(onbep,det,stan,nom,zonder,zonder-n)	NOU-C(number=sg)
VNW(onbep,det,stan,prenom,met-e,agr)	PD(type=indef,subtype=oth,position=prenom)
VNW(onbep,det,stan,prenom,met-e,evz)	PD(type=indef,subtype=oth,position=prenom)
VNW(onbep,det,stan,prenom,met-e,mv)	PD(type=indef,subtype=oth,position=prenom)
VNW(onbep,det,stan,prenom,met-e,rest)	PD(type=indef,subtype=oth,position=prenom)
VNW(onbep,det,stan,prenom,zonder,agr)	PD(type=indef,subtype=oth,position=prenom)
VNW(onbep,det,stan,prenom,zonder,evon)	PD(type=indef,subtype=oth,position=prenom)
VNW(onbep,det,stan,vrij,zonder)	PD(type=indef,position=free)
VNW(onbep,grad,gen,nom,met-e,mv-n,basis)	PD(type=indef,position=free)
VNW(onbep,grad,stan,nom,met-e,mv-n,basis)	PD(type=indef,position=free)
VNW(onbep,grad,stan,nom,met-e,mv-n,sup)	NOU-C(number=pl)
VNW(onbep,grad,stan,nom,met-e,zonder-n,basis)	NOU-C(number=sg)
VNW(onbep,grad,stan,nom,met-e,zonder-n,sup)	NOU-C(number=uncl)
VNW(onbep,grad,stan,nom,zonder,mv-n,dim)	NUM(type=card,position=free,representation=uncl)
VNW(onbep,grad,stan,prenom,met-e,agr,basis)	PD(type=indef,subtype=oth,position=prenom)
VNW(onbep,grad,stan,prenom,met-e,agr,comp)	PD(type=indef,subtype=oth,position=prenom)
VNW(onbep,grad,stan,prenom,met-e,agr,sup)	PD(type=indef,subtype=oth,position=prenom)
VNW(onbep,grad,stan,prenom,met-e,mv,basis)	NUM(type=card,position=prenom,representation=uncl)
VNW(onbep,grad,stan,prenom,zonder,agr,basis)	PD(type=indef,subtype=oth,position=prenom)
VNW(onbep,grad,stan,prenom,zonder,agr,comp)	PD(type=indef,subtype=oth,position=prenom)
VNW(onbep,grad,stan,vrij,zonder,basis)	PD(type=indef,position=free)
VNW(onbep,grad,stan,vrij,zonder,comp)	PD(type=indef,position=free)
VNW(onbep,grad,stan,vrij,zonder,sup)	PD(type=indef,position=free)
VNW(onbep,pron,dial)	PD(type=indef,position=free)
VNW(onbep,pron,gen,vol,3p,ev)	PD(type=indef,position=free)
VNW(onbep,pron,stan,vol,3o,ev)	PD(type=indef,position=free)
VNW(onbep,pron,stan,vol,3p,ev)	PD(type=indef,position=free)
VNW(pers,pron,dial)	PD(type=pers,position=free)
VNW(pers,pron,gen,vol,1,ev)	PD(type=pers,position=free)
VNW(pers,pron,gen,vol,1,mv)	PD(type=pers,position=free)
VNW(pers,pron,gen,vol,2,getal)	PD(type=pers,position=free)
VNW(pers,pron,gen,vol,3m,ev)	PD(type=pers,position=free)
VNW(pers,pron,gen,vol,3p,mv)	PD(type=pers,position=free)
VNW(pers,pron,gen,vol,3v,getal)	PD(type=pers,position=free)
VNW(pers,pron,nomin,nadr,1,ev)	PD(type=pers,position=free)
VNW(pers,pron,nomin,nadr,1,mv)	PD(type=pers,position=free)
VNW(pers,pron,nomin,nadr,2,getal)	PD(type=pers,position=free)
VNW(pers,pron,nomin,nadr,2b,getal)	PD(type=pers,position=free)
VNW(pers,pron,nomin,nadr,2v,ev)	PD(type=pers,position=free)
VNW(pers,pron,nomin,nadr,3m,ev,masc)	PD(type=pers,position=free)
VNW(pers,pron,nomin,nadr,3p,mv)	PD(type=pers,position=free)
VNW(pers,pron,nomin,nadr,3v,ev,fem)	PD(type=pers,position=free)
VNW(pers,pron,nomin,red,1,ev)	PD(type=pers,position=free)
VNW(pers,pron,nomin,red,1,mv)	PD(type=pers,position=free)
VNW(pers,pron,nomin,red,2,getal)	PD(type=pers,position=free)
VNW(pers,pron,nomin,red,2v,ev)	PD(type=pers,position=free)
VNW(pers,pron,nomin,red,3,ev,masc)	PD(type=pers,position=free)
VNW(pers,pron,nomin,red,3p,ev,masc)	PD(type=pers,position=free)
VNW(pers,pron,nomin,vol,1,ev)	PD(type=pers,position=free)
VNW(pers,pron,nomin,vol,1,mv)	PD(type=pers,position=free)
VNW(pers,pron,nomin,vol,2,getal)	PD(type=pers,position=free)
VNW(pers,pron,nomin,vol,2b,getal)	PD(type=pers,position=free)
VNW(pers,pron,nomin,vol,2v,ev)	PD(type=pers,position=free)
VNW(pers,pron,nomin,vol,3,ev,masc)	PD(type=pers,position=free)
VNW(pers,pron,nomin,vol,3p,mv)	PD(type=pers,position=free)
VNW(pers,pron,nomin,vol,3v,ev,fem)	PD(type=pers,position=free)
VNW(pers,pron,obl,nadr,3m,ev,masc)	PD(type=pers,position=free)
VNW(pers,pron,obl,nadr,3p,mv)	PD(type=pers,position=free)
VNW(pers,pron,obl,nadr,3v,getal,fem)	PD(type=pers,position=free)
VNW(pers,pron,obl,red,3,ev,masc)	PD(type=pers,position=free)
VNW(pers,pron,obl,red,3v,getal,fem)	PD(type=pers,position=free)
VNW(pers,pron,obl,vol,2v,ev)	PD(type=pers,position=free)
VNW(pers,pron,obl,vol,3,ev,masc)	PD(type=pers,position=free)
VNW(pers,pron,obl,vol,3,getal,fem)	PD(type=pers,position=free)
VNW(pers,pron,obl,vol,3p,mv)	PD(type=pers,position=free)
VNW(pers,pron,stan,nadr,2v,mv)	PD(type=pers,position=free)
VNW(pers,pron,stan,red,3,ev,fem)	PD(type=pers,position=free)
VNW(pers,pron,stan,red,3,ev,onz)	PD(type=pers,position=free)
VNW(pers,pron,stan,red,3,mv)	PD(type=pers,position=free)
VNW(pr,pron,obl,nadr,1,ev)	PD(type=pers|refl,position=free)
VNW(pr,pron,obl,nadr,1,mv)	PD(type=pers|refl,position=free)
VNW(pr,pron,obl,nadr,2,getal)	PD(type=pers|refl,position=free)
VNW(pr,pron,obl,nadr,2v,getal)	PD(type=pers|refl,position=free)
VNW(pr,pron,obl,red,1,ev)	PD(type=pers|refl,position=free)
VNW(pr,pron,obl,red,2v,getal)	PD(type=pers|refl,position=free)
VNW(pr,pron,obl,vol,1,ev)	PD(type=pers|refl,position=free)
VNW(pr,pron,obl,vol,1,mv)	PD(type=pers|refl,position=free)
VNW(pr,pron,obl,vol,2,getal)	PD(type=pers|refl,position=free)
VNW(recip,pron,dial)	PD(type=recip,position=free)
VNW(recip,pron,gen,vol,persoon,mv)	PD(type=recip,position=free)
VNW(recip,pron,obl,vol,persoon,mv)	PD(type=recip,position=free)
VNW(refl,pron,dial)	PD(type=refl,position=free)
VNW(refl,pron,obl,nadr,3,getal)	PD(type=refl,position=free)
VNW(refl,pron,obl,red,3,getal)	PD(type=refl,position=free)
VNW(vb,adv-pron,obl,vol,3o,getal)	ADV(type=uncl)
VNW(vb,det,stan,nom,met-e,zonder-n)	PD(type=inter|rel,position=free)
VNW(vb,det,stan,prenom,met-e,rest)	PD(type=inter|rel,position=prenom)
VNW(vb,det,stan,prenom,zonder,evon)	PD(type=inter|rel,position=prenom)
VNW(vb,pron,gen,vol,3m,ev)	PD(type=inter|rel,position=free)
VNW(vb,pron,gen,vol,3p,mv)	PD(type=inter|rel,position=free)
VNW(vb,pron,gen,vol,3v,ev)	PD(type=inter|rel,position=free)
VNW(vb,pron,stan,vol,3o,ev)	PD(type=inter|rel,position=free)
VNW(vb,pron,stan,vol,3p,getal)	PD(type=inter|rel,position=free)
VNW(vrag,det,dial)	PD(type=inter,position=uncl)
VNW(vrag,pron,dial)	PD(type=inter,position=free)
VNW(vrag,pron,stan,nadr,3o,ev)	INT()
VZ(fin)	ADP(type=post)
VZ(fin,dial)	ADP(type=post)
VZ(init)	ADP(type=pre)
VZ(init,dial)	ADP(type=pre)
VZ(versm)	ADP(type=pre)
VZ(versm)[1]	PD(type=dem|indef,subtype=art,position=prenom)
WW(dial)	VRB(finiteness=uncl,tense=uncl)
WW(inf,nom,zonder,zonder-n)	NOU-C(number=sg)
WW(inf,prenom,met-e)	VRB(finiteness=inf)
WW(inf,prenom,zonder)	VRB(finiteness=inf)
WW(inf,vrij,zonder)	VRB(finiteness=inf)
WW(od,nom,met-e,mv-n)	NOU-C(number=pl)
WW(od,nom,met-e,zonder-n)	NOU-C(number=sg)
WW(od,prenom,met-e)	AA(degree=pos,position=prenom)
WW(od,prenom,zonder)	AA(degree=pos,position=prenom)
WW(od,vrij,zonder)	VRB(finiteness=prespart)
WW(pv,conj,ev)	VRB(finiteness=fin,tense=uncl)
WW(pv,tgw,ev)	VRB(finiteness=fin,tense=pres)
WW(pv,tgw,met-t)	VRB(finiteness=fin,tense=pres)
WW(pv,tgw,mv)	VRB(finiteness=fin,tense=pres)
WW(pv,verl,ev)	VRB(finiteness=fin,tense=past)
WW(pv,verl,met-t)	VRB(finiteness=fin,tense=past)
WW(pv,verl,mv)	VRB(finiteness=fin,tense=past)
WW(vd,nom,met-e,mv-n)	NOU-C(number=pl)
WW(vd,nom,met-e,zonder-n)	NOU-C(number=sg)
WW(vd,prenom,met-e)	AA(degree=pos,position=prenom)
WW(vd,prenom,zonder)	AA(degree=pos,position=prenom)
WW(vd,vrij,zonder)	VRB(finiteness=pastpart)
WW(vd,vrij,zonder)[1]	AA(degree=pos,position=free)
