ADJ(vrij,comp,zonder)	AA(degree=comp,position=free,inflection=0,case=nom|dat|acc|voc)	AA(degree=comp,position=free,case=nom|dat|acc|voc,inflection=0)
ADJ(postnom,comp,zonder)	AA(degree=comp,position=postnom,inflection=0,case=nom|dat|acc|voc)	AA(degree=comp,position=postnom,case=nom|dat|acc|voc,inflection=0)
ADJ(prenom,comp,met-e,bijz)	AA(degree=comp,position=prenom,inflection=n,case=gen|dat)	AA(degree=comp,position=prenom,case=gen|dat,inflection=n)
ADJ(prenom,comp,zonder)	AA(degree=comp,position=prenom,inflection=0,case=nom|dat|acc|voc)	AA(degree=comp,position=prenom,case=nom|dat|acc|voc,inflection=0)
ADJ(prenom,comp,met-e,stan)	AA(degree=comp,position=prenom,inflection=e,case=nom|dat|acc|voc)	AA(degree=comp,position=prenom,case=nom|dat|acc|voc,inflection=e)
WW(vd,vrij,zonder)[1]	AA(degree=pos,position=free,inflection=0,case=nom|dat|acc|voc)	AA(degree=pos,position=free,case=nom|dat|acc|voc,inflection=0)
ADJ(vrij,basis,zonder)	AA(degree=pos,position=free,inflection=0,case=nom|dat|acc|voc)	AA(degree=pos,position=free,case=nom|dat|acc|voc,inflection=0)
ADJ(vrij,dim,zonder)	AA(degree=pos,position=free,inflection=0,case=nom|dat|acc|voc)	AA(degree=pos,position=free,case=nom|dat|acc|voc,inflection=0)
ADJ(postnom,basis,zonder)	AA(degree=pos,position=postnom,inflection=0,case=nom|dat|acc|voc)	AA(degree=pos,position=postnom,case=nom|dat|acc|voc,inflection=0)
ADJ(prenom,basis,met-e,bijz)	AA(degree=pos,position=prenom,inflection=n|r/re,case=gen|dat)	AA(degree=pos,position=prenom,case=gen|dat,inflection=n|r/re)
ADJ(prenom,basis,zonder)	AA(degree=pos,position=prenom,inflection=0,case=nom|dat|acc|voc)	AA(degree=pos,position=prenom,case=nom|dat|acc|voc,inflection=0)
WW(od,prenom,zonder)	AA(degree=pos,position=prenom,inflection=0,case=nom|dat|acc|voc)	AA(degree=pos,position=prenom,case=nom|dat|acc|voc,inflection=0)
WW(vd,prenom,zonder)	AA(degree=pos,position=prenom,inflection=0,case=nom|dat|acc|voc)	AA(degree=pos,position=prenom,case=nom|dat|acc|voc,inflection=0)
WW(od,prenom,met-e)	AA(degree=pos,position=prenom,inflection=e,case=nom|dat|acc|voc)	AA(degree=pos,position=prenom,case=nom|dat|acc|voc,inflection=e)
ADJ(prenom,basis,met-e,stan)	AA(degree=pos,position=prenom,inflection=e,case=nom|dat|acc|voc)	AA(degree=pos,position=prenom,case=nom|dat|acc|voc,inflection=e)
WW(vd,prenom,met-e)	AA(degree=pos,position=prenom,inflection=e,case=nom|dat|acc|voc)	AA(degree=pos,position=prenom,case=nom|dat|acc|voc,inflection=e)
ADJ(vrij,sup,zonder)	AA(degree=sup,position=free,inflection=0,case=nom|dat|acc|voc)	AA(degree=sup,position=free,case=nom|dat|acc|voc,inflection=0)
ADJ(prenom,sup,met-e,bijz)	AA(degree=sup,position=prenom,inflection=r/re,case=gen|dat)	AA(degree=sup,position=prenom,case=gen|dat,inflection=r/re)
ADJ(prenom,sup,zonder)	AA(degree=sup,position=prenom,inflection=0,case=nom|dat|acc|voc)	AA(degree=sup,position=prenom,case=nom|dat|acc|voc,inflection=0)
ADJ(prenom,sup,met-e,stan)	AA(degree=sup,position=prenom,inflection=e,case=nom|dat|acc|voc)	AA(degree=sup,position=prenom,case=nom|dat|acc|voc,inflection=e)
ADJ(dial)	AA(degree=uncl,position=uncl,case=uncl,inflection=uncl)	AA(degree=uncl,position=uncl,case=uncl,inflection=uncl)
VZ(fin,dial)	ADP(type=post)	ADP(type=post)
VZ(fin)	ADP(type=post)	ADP(type=post)
VZ(init)	ADP(type=pre)	ADP(type=pre)
VZ(versm)	ADP(type=pre)	ADP(type=pre)
VZ(init,dial)	ADP(type=pre)	ADP(type=pre)
VNW(onbep,adv-pron,obl,vol,3o,getal)	ADV(type=reg)	ADV(type=reg)
VNW(aanw,adv-pron,obl,vol,3o,getal)	ADV(type=uncl)	ADV(type=uncl)
VNW(vb,adv-pron,obl,vol,3o,getal)	ADV(type=uncl)	ADV(type=uncl)
BW(dial)	ADV(type=uncl)	ADV(type=uncl)
BW()	ADV(type=uncl)	ADV(type=uncl)
VNW(aanw,adv-pron,stan,red,3,getal)	ADV(type=uncl)	ADV(type=uncl)
VG(neven)	CONJ(type=coor)	CONJ(type=coor)
VG(onder,dial)	CONJ(type=sub)	CONJ(type=sub)
VG(onder)	CONJ(type=sub)	CONJ(type=sub)
VNW(vrag,pron,stan,nadr,3o,ev)	INT()	INT()
TSW()	INT()	INT()
TSW(dial)	INT()	INT()
VNW(bez,det,stan,vol,2v,ev,nom,met-e,mv-n)	NOU-C(number=pl,inflection=n)	NOU-C(number=pl,inflection=n)
ADJ(nom,comp,met-e,mv-n)	NOU-C(number=pl,inflection=n)	NOU-C(number=pl,inflection=n)
VNW(bez,det,stan,vol,2,getal,nom,met-e,mv-n)	NOU-C(number=pl,inflection=n)	NOU-C(number=pl,inflection=n)
TW(rang,nom,mv-n)	NOU-C(number=pl,inflection=n)	NOU-C(number=pl,inflection=n)
VNW(bez,det,stan,vol,1,ev,nom,met-e,mv-n)	NOU-C(number=pl,inflection=n)	NOU-C(number=pl,inflection=n)
WW(od,nom,met-e,mv-n)	NOU-C(number=pl,inflection=n)	NOU-C(number=pl,inflection=n)
VNW(bez,det,stan,vol,3m,ev,nom,met-e,mv-n)	NOU-C(number=pl,inflection=n)	NOU-C(number=pl,inflection=n)
VNW(bez,det,stan,vol,3p,mv,nom,met-e,mv-n)	NOU-C(number=pl,inflection=n)	NOU-C(number=pl,inflection=n)
VNW(bez,det,stan,vol,1,mv,nom,met-e,mv-n)	NOU-C(number=pl,inflection=n)	NOU-C(number=pl,inflection=n)
VNW(bez,det,stan,vol,3v,ev,nom,met-e,mv-n)	NOU-C(number=pl,inflection=n)	NOU-C(number=pl,inflection=n)
ADJ(nom,sup,met-e,mv-n)	NOU-C(number=pl,inflection=n)	NOU-C(number=pl,inflection=n)
ADJ(nom,basis,zonder,mv-n)	NOU-C(number=pl,inflection=n)	NOU-C(number=pl,inflection=n)
WW(vd,nom,met-e,mv-n)	NOU-C(number=pl,inflection=n)	NOU-C(number=pl,inflection=n)
ADJ(nom,basis,met-e,mv-n)	NOU-C(number=pl,inflection=n)	NOU-C(number=pl,inflection=n)
VNW(onbep,grad,stan,nom,met-e,mv-n,sup)	NOU-C(number=pl,inflection=n)	NOU-C(number=pl,inflection=n)
N(soort,mv,dim)	NOU-C(number=pl,inflection=s/th)	NOU-C(number=pl,inflection=s/th)
N(soort,mv,basis)	NOU-C(number=pl,inflection=uncl)	NOU-C(number=pl,inflection=uncl)
N(soort,ev,basis,dat)	NOU-C(number=sg,case=dat,inflection=e,gender=uncl)	NOU-C(number=sg,case=dat,gender=uncl,inflection=e)
VNW(bez,det,dat,vol,1,mv,nom,met-e,zonder-n)	NOU-C(case=dat,number=sg,inflection=nt,gender=uncl)	NOU-C(number=sg,case=dat,gender=uncl,inflection=nt)
VNW(bez,det,dat,vol,3m,ev,nom,met-e,zonder-n)	NOU-C(case=dat,number=sg,inflection=nt,gender=uncl)	NOU-C(number=sg,case=dat,gender=uncl,inflection=nt)
VNW(bez,det,dat,vol,2,getal,nom,met-e,zonder-n)	NOU-C(case=dat,number=sg,inflection=nt,gender=uncl)	NOU-C(number=sg,case=dat,gender=uncl,inflection=nt)
VNW(bez,det,dat,vol,1,ev,nom,met-e,zonder-n)	NOU-C(case=dat,number=sg,inflection=nt,gender=uncl)	NOU-C(number=sg,case=dat,gender=uncl,inflection=nt)
VNW(bez,det,dat,vol,3v,ev,nom,met-e,zonder-n)	NOU-C(case=dat,number=sg,inflection=nt,gender=uncl)	NOU-C(number=sg,case=dat,gender=uncl,inflection=nt)
VNW(bez,det,dat,vol,3p,mv,nom,met-e,zonder-n)	NOU-C(case=dat,number=sg,inflection=nt,gender=uncl)	NOU-C(number=sg,case=dat,gender=uncl,inflection=nt)
N(soort,ev,basis,gen)	NOU-C(number=sg,case=gen,inflection=s/th,gender=m|n)	NOU-C(number=sg,case=gen,gender=m|n,inflection=s/th)
ADJ(postnom,comp,met-s)	NOU-C(number=sg,inflection=s/th,gender=n,case=gen)	NOU-C(number=sg,case=gen,gender=n,inflection=s/th)
ADJ(postnom,basis,met-s)	NOU-C(number=sg,inflection=s/th,gender=n,case=gen)	NOU-C(number=sg,case=gen,gender=n,inflection=s/th)
N(soort,ev,dim,gen)	NOU-C(number=sg,case=gen,inflection=s/th,gender=n)	NOU-C(number=sg,case=gen,gender=n,inflection=s/th)
ADJ(nom,sup,met-e,zonder-n,bijz)	NOU-C(number=sg,inflection=n,case=gen|dat,gender=uncl)	NOU-C(number=sg,case=gen|dat,gender=uncl,inflection=n)
ADJ(nom,basis,met-e,zonder-n,bijz)	NOU-C(number=sg,inflection=n,case=gen|dat,gender=uncl)	NOU-C(number=sg,case=gen|dat,gender=uncl,inflection=n)
ADJ(nom,comp,met-e,zonder-n,bijz)	NOU-C(number=sg,inflection=uncl,case=gen|dat,gender=uncl)	NOU-C(number=sg,case=gen|dat,gender=uncl,inflection=uncl)
N(soort,ev,basis,zijd,stan)	NOU-C(number=sg,case=nom|dat|acc|voc,gender=m|f,inflection=0)	NOU-C(number=sg,case=nom|dat|acc|voc,gender=m|f,inflection=0)
WW(inf,nom,zonder,zonder-n)	NOU-C(number=sg,inflection=0,gender=n,case=nom|dat|acc|voc)	NOU-C(number=sg,case=nom|dat|acc|voc,gender=n,inflection=0)
VNW(onbep,grad,stan,nom,met-e,zonder-n,basis)	NOU-C(case=nom|dat|acc|voc,number=sg,gender=n,inflection=0)	NOU-C(number=sg,case=nom|dat|acc|voc,gender=n,inflection=0)
ADJ(nom,comp,zonder,zonder-n)	NOU-C(number=sg,inflection=0,gender=n,case=nom|dat|acc|voc)	NOU-C(number=sg,case=nom|dat|acc|voc,gender=n,inflection=0)
N(soort,ev,basis,onz,stan)	NOU-C(number=sg,case=nom|dat|acc|voc,gender=n,inflection=0)	NOU-C(number=sg,case=nom|dat|acc|voc,gender=n,inflection=0)
N(soort,ev,dim,onz,stan)	NOU-C(number=sg,case=nom|dat|acc|voc,gender=n,inflection=0)	NOU-C(number=sg,case=nom|dat|acc|voc,gender=n,inflection=0)
ADJ(nom,sup,met-e,zonder-n,stan)	NOU-C(number=sg,inflection=e,case=nom|dat|acc|voc,gender=n)	NOU-C(number=sg,case=nom|dat|acc|voc,gender=n,inflection=e)
WW(od,nom,met-e,zonder-n)	NOU-C(number=sg,inflection=0,gender=uncl,case=nom|dat|acc|voc)	NOU-C(number=sg,case=nom|dat|acc|voc,gender=uncl,inflection=0)
VNW(onbep,det,stan,nom,zonder,zonder-n)	NOU-C(case=nom|dat|acc|voc,number=sg,inflection=0,gender=uncl)	NOU-C(number=sg,case=nom|dat|acc|voc,gender=uncl,inflection=0)
WW(vd,nom,met-e,zonder-n)	NOU-C(number=sg,inflection=0,gender=uncl,case=nom|dat|acc|voc)	NOU-C(number=sg,case=nom|dat|acc|voc,gender=uncl,inflection=0)
VNW(bez,det,stan,vol,1,ev,nom,met-e,zonder-n)	NOU-C(case=nom|dat|acc|voc,number=sg,inflection=0,gender=uncl)	NOU-C(number=sg,case=nom|dat|acc|voc,gender=uncl,inflection=0)
N(soort,ev,basis,genus,stan)	NOU-C(number=sg,case=nom|dat|acc|voc,gender=uncl,inflection=0)	NOU-C(number=sg,case=nom|dat|acc|voc,gender=uncl,inflection=0)
TW(rang,nom,zonder-n)[1]	NOU-C(number=sg,inflection=0,gender=uncl,case=nom|dat|acc|voc)	NOU-C(number=sg,case=nom|dat|acc|voc,gender=uncl,inflection=0)
VNW(bez,det,stan,vol,2,getal,nom,met-e,zonder-n)	NOU-C(case=nom|dat|acc|voc,number=sg,inflection=0,gender=uncl)	NOU-C(number=sg,case=nom|dat|acc|voc,gender=uncl,inflection=0)
ADJ(nom,basis,zonder,zonder-n)	NOU-C(number=sg,inflection=0,gender=uncl,case=nom|dat|acc|voc)	NOU-C(number=sg,case=nom|dat|acc|voc,gender=uncl,inflection=0)
ADJ(nom,sup,zonder,zonder-n)	NOU-C(number=sg,inflection=0,gender=uncl,case=nom|dat|acc|voc)	NOU-C(number=sg,case=nom|dat|acc|voc,gender=uncl,inflection=0)
VNW(bez,det,stan,vol,1,mv,nom,met-e,zonder-n)	NOU-C(case=nom|dat|acc|voc,number=sg,inflection=0,gender=uncl)	NOU-C(number=sg,case=nom|dat|acc|voc,gender=uncl,inflection=0)
VNW(bez,det,stan,vol,3v,ev,nom,met-e,zonder-n)	NOU-C(case=nom|dat|acc|voc,number=sg,inflection=0,gender=uncl)	NOU-C(number=sg,case=nom|dat|acc|voc,gender=uncl,inflection=0)
VNW(bez,det,stan,vol,2v,ev,nom,met-e,zonder-n)	NOU-C(case=nom|dat|acc|voc,number=sg,inflection=0,gender=uncl)	NOU-C(number=sg,case=nom|dat|acc|voc,gender=uncl,inflection=0)
VNW(bez,det,stan,vol,3m,ev,nom,met-e,zonder-n)	NOU-C(case=nom|dat|acc|voc,number=sg,inflection=0,gender=uncl)	NOU-C(number=sg,case=nom|dat|acc|voc,gender=uncl,inflection=0)
VNW(bez,det,stan,vol,3p,mv,nom,met-e,zonder-n)	NOU-C(case=nom|dat|acc|voc,number=sg,inflection=0,gender=uncl)	NOU-C(number=sg,case=nom|dat|acc|voc,gender=uncl,inflection=0)
VNW(onbep,det,stan,nom,met-e,zonder-n)	NOU-C(case=nom|dat|acc|voc,number=sg,inflection=e,gender=uncl)	NOU-C(number=sg,case=nom|dat|acc|voc,gender=uncl,inflection=e)
ADJ(nom,comp,met-e,zonder-n,stan)	NOU-C(number=sg,inflection=e,case=nom|dat|acc|voc,gender=uncl)	NOU-C(number=sg,case=nom|dat|acc|voc,gender=uncl,inflection=e)
ADJ(nom,basis,met-e,zonder-n,stan)	NOU-C(number=sg,inflection=e,case=nom|dat|acc|voc,gender=uncl)	NOU-C(number=sg,case=nom|dat|acc|voc,gender=uncl,inflection=e)
VNW(onbep,grad,stan,nom,met-e,zonder-n,sup)	NOU-C(case=nom|dat|acc|voc,number=uncl,gender=uncl,inflection=0)	NOU-C(number=uncl,case=nom|dat|acc|voc,gender=uncl,inflection=0)
N(soort,dial)	NOU-C(number=uncl,case=uncl,gender=uncl,inflection=uncl)	NOU-C(number=uncl,case=uncl,gender=uncl,inflection=uncl)
N(eigen,mv,basis)	NOU-P(number=pl,inflection=n)	NOU-P(number=pl,inflection=n)
N(eigen,mv,dim)	NOU-P(number=pl,inflection=s/th)	NOU-P(number=pl,inflection=s/th)
N(eigen,ev,basis,dat)	NOU-P(number=sg,case=dat,gender=uncl,inflection=e)	NOU-P(number=sg,case=dat,gender=uncl,inflection=e)
N(eigen,ev,basis,gen)	NOU-P(number=sg,case=gen,gender=uncl,inflection=n|s/th)	NOU-P(number=sg,case=gen,gender=uncl,inflection=n|s/th)
N(eigen,ev,dim,gen)	NOU-P(number=sg,case=gen,gender=uncl,inflection=s/th)	NOU-P(number=sg,case=gen,gender=uncl,inflection=s/th)
N(eigen,ev,basis,zijd,stan)	NOU-P(number=sg,case=nom|dat|acc|voc,gender=m|f,inflection=0)	NOU-P(number=sg,case=nom|dat|acc|voc,gender=m|f,inflection=0)
N(eigen,ev,basis,onz,stan)	NOU-P(number=sg,case=nom|dat|acc|voc,gender=n,inflection=0)	NOU-P(number=sg,case=nom|dat|acc|voc,gender=n,inflection=0)
N(eigen,ev,dim,onz,stan)	NOU-P(number=sg,case=nom|dat|acc|voc,gender=n,inflection=0)	NOU-P(number=sg,case=nom|dat|acc|voc,gender=n,inflection=0)
N(eigen,ev,basis,genus,stan)	NOU-P(number=sg,case=nom|dat|acc|voc,gender=uncl,inflection=0)	NOU-P(number=sg,case=nom|dat|acc|voc,gender=uncl,inflection=0)
N(eigen,dial)	NOU-P(number=uncl,case=uncl,gender=uncl,inflection=uncl)	NOU-P(number=uncl,case=uncl,gender=uncl,inflection=uncl)
SPEC(deeleigen)	NOU-P(number=uncl,inflection=uncl)	NOU-P(number=uncl,case=uncl,gender=uncl,inflection=uncl)
TW(hoofd,nom,zonder-n,basis)	NUM(type=card,position=free,representation=dig|let|rom|mix-dig|mix-rom,inflection=0)	NUM(type=card,position=free,representation=dig|let|rom|mix-dig|mix-rom,inflection=0)
TW(hoofd,nom,zonder-n,dim)	NUM(type=card,position=free,representation=dig|let|rom|mix-dig|mix-rom,inflection=0)	NUM(type=card,position=free,representation=dig|let|rom|mix-dig|mix-rom,inflection=0)
TW(hoofd,nom,mv-n,basis)	NUM(type=card,position=free,representation=dig|let|rom|mix-dig|mix-rom,inflection=n)	NUM(type=card,position=free,representation=dig|let|rom|mix-dig|mix-rom,inflection=n)
TW(hoofd,nom,mv-n,dim)	NUM(type=card,position=free,representation=dig|let|rom|mix-dig|mix-rom,inflection=s/th)	NUM(type=card,position=free,representation=dig|let|rom|mix-dig|mix-rom,inflection=s/th)
VNW(onbep,grad,stan,nom,zonder,mv-n,dim)	NUM(type=card,position=free,representation=dig|let|rom|mix-dig|mix-rom,inflection=s/th)	NUM(type=card,position=free,representation=dig|let|rom|mix-dig|mix-rom,inflection=s/th)
TW(hoofd,prenom,bijz)	NUM(type=card,position=prenom,representation=dig|let|rom|mix-dig|mix-rom,case=gen|dat,inflection=s/th|n)	NUM(type=card,position=prenom,representation=dig|let|rom|mix-dig|mix-rom,case=gen|dat,inflection=n|s/th)
VNW(onbep,grad,stan,prenom,met-e,mv,basis)	NUM(type=card,position=prenom,representation=dig|let|rom|mix-dig|mix-rom,case=nom|dat|acc|voc,inflection=0)	NUM(type=card,position=prenom,representation=dig|let|rom|mix-dig|mix-rom,case=nom|dat|acc|voc,inflection=0)
TW(hoofd,prenom,stan)	NUM(type=card,position=prenom,representation=dig|let|rom|mix-dig|mix-rom,case=nom|dat|acc|voc,inflection=0)	NUM(type=card,position=prenom,representation=dig|let|rom|mix-dig|mix-rom,case=nom|dat|acc|voc,inflection=0)
TW(hoofd,vrij)	NUM(type=card,position=free|prenom|postnom,representation=dig|let|rom|mix-dig|mix-rom,inflection=0)	NUM(type=card,position=prenom|postnom|free,representation=dig|let|rom|mix-dig|mix-rom,case=uncl,inflection=0)
TW(hoofd,dial)	NUM(type=card,position=uncl,representation=dig|let|rom|mix-dig|mix-rom,case=uncl,inflection=uncl)	NUM(type=card,position=uncl,representation=dig|let|rom|mix-dig|mix-rom,case=uncl,inflection=uncl)
TW(rang,nom,zonder-n)	NUM(type=ord,position=free,representation=dig|let|rom|mix-dig|mix-rom,case=nom|dat|acc|voc,inflection=e)	NUM(type=ord,position=free,representation=dig|let|rom|mix-dig|mix-rom,case=nom|dat|acc|voc,inflection=e)
TW(rang,prenom,bijz)	NUM(type=ord,position=prenom,representation=dig|let|rom|mix-dig|mix-rom,case=gen|dat,inflection=r/re)	NUM(type=ord,position=prenom,representation=dig|let|rom|mix-dig|mix-rom,case=gen|dat,inflection=r/re)
TW(rang,prenom,stan)	NUM(type=ord,position=prenom,representation=dig|let|rom|mix-dig|mix-rom,case=nom|dat|acc|voc,inflection=0)	NUM(type=ord,position=prenom,representation=dig|let|rom|mix-dig|mix-rom,case=nom|dat|acc|voc,inflection=0)
TW(rang,dial)	NUM(type=ord,position=uncl,representation=dig|let|rom|mix-dig|mix-rom,case=uncl,inflection=uncl)	NUM(type=ord,position=uncl,representation=dig|let|rom|mix-dig|mix-rom,case=uncl,inflection=uncl)
LET()	PC	PC()
VNW(aanw,det,dat,nom,met-e,zonder-n)	PD(type=dem,case=dat,position=free,inflection=n,number=uncl,gender=uncl)	PD(type=dem,position=free,case=dat,number=uncl,gender=uncl,inflection=n)
VNW(aanw,pron,gen,vol,3m,ev)	PD(type=dem,case=gen,number=sg,gender=m,position=free,inflection=s/th)	PD(type=dem,position=free,case=gen,number=sg,gender=m,inflection=s/th)
VNW(aanw,pron,gen,vol,3o,ev)	PD(type=dem,case=gen,number=sg,gender=uncl,position=free,inflection=s/th)	PD(type=dem,position=free,case=gen,number=sg,gender=uncl,inflection=s/th)
VNW(aanw,det,gen,nom,met-e,zonder-n)	PD(type=dem,case=gen,position=free,inflection=r/re|s/th,number=uncl,gender=uncl)	PD(type=dem,position=free,case=gen,number=uncl,gender=uncl,inflection=r/re|s/th)
VNW(aanw,det,stan,nom,met-e,mv-n)	PD(type=dem,case=nom|dat|acc|voc,position=free,inflection=n,number=pl,gender=uncl)	PD(type=dem,position=free,case=nom|dat|acc|voc,number=pl,gender=uncl,inflection=n)
VNW(aanw,pron,stan,vol,3o,ev)	PD(type=dem,case=nom|dat|acc|voc,number=sg,gender=uncl,position=free,inflection=0)	PD(type=dem,position=free,case=nom|dat|acc|voc,number=sg,gender=uncl,inflection=0)
VNW(aanw,det,stan,nom,met-e,zonder-n)	PD(type=dem,case=nom|dat|acc|voc,position=free,inflection=0,number=sg,gender=uncl)	PD(type=dem,position=free,case=nom|dat|acc|voc,number=sg,gender=uncl,inflection=0)
VNW(aanw,pron,stan,nadr,3o,ev)	PD(type=dem,case=nom|dat|acc|voc,number=sg,gender=uncl,position=free,inflection=e)	PD(type=dem,position=free,case=nom|dat|acc|voc,number=sg,gender=uncl,inflection=e)
VNW(aanw,pron,stan,vol,3,getal)	PD(type=dem,case=nom|dat|acc|voc,number=uncl,gender=uncl,position=free,inflection=0)	PD(type=dem,position=free,case=nom|dat|acc|voc,number=uncl,gender=uncl,inflection=0)
VNW(aanw,det,stan,vrij,zonder)	PD(type=dem,case=nom|dat|acc|voc,position=free,inflection=0,number=uncl,gender=uncl)	PD(type=dem,position=free,case=nom|dat|acc|voc,number=uncl,gender=uncl,inflection=0)
VNW(aanw,pron,dial)	PD(type=dem,position=free,case=uncl,number=uncl,gender=uncl,inflection=uncl)	PD(type=dem,position=free,case=uncl,number=uncl,gender=uncl,inflection=uncl)
VNW(aanw,det,dial)	PD(type=dem,position=uncl,case=uncl,number=uncl,gender=uncl,inflection=uncl)	PD(type=dem,position=uncl,case=uncl,number=uncl,gender=uncl,inflection=uncl)
LID(bep,dat,mv)	PD(type=dem,subtype=art,position=prenom,case=dat,number=pl,gender=uncl,inflection=n)	PD(type=dem,subtype=art,position=prenom,case=dat,number=pl,gender=uncl,inflection=n)
LID(bep,dat,evf)	PD(type=dem,subtype=art,position=prenom,case=dat,number=sg,gender=f,inflection=r/re)	PD(type=dem,subtype=art,position=prenom,case=dat,number=sg,gender=f,inflection=r/re)
LID(bep,dat,evmo)	PD(type=dem,subtype=art,position=prenom,case=dat,number=sg,gender=m|n,inflection=n)	PD(type=dem,subtype=art,position=prenom,case=dat,number=sg,gender=m|n,inflection=n)
LID(bep,gen,evmo)	PD(type=dem,subtype=art,position=prenom,case=gen,number=sg,gender=m|n,inflection=s/th)	PD(type=dem,subtype=art,position=prenom,case=gen,number=sg,gender=m|n,inflection=s/th)
LID(bep,gen,rest3)	PD(type=dem,subtype=art,position=prenom,case=gen,number=uncl,gender=uncl,inflection=r/re)	PD(type=dem,subtype=art,position=prenom,case=gen,number=uncl,gender=uncl,inflection=r/re)
LID(bep,stan,evon)	PD(type=dem,subtype=art,position=prenom,case=nom|dat|acc|voc,number=sg,gender=n,inflection=0)	PD(type=dem,subtype=art,position=prenom,case=nom|dat|acc|voc,number=sg,gender=n,inflection=0)
LID(bep,stan,rest)	PD(type=dem,subtype=art,position=prenom,case=nom|dat|acc|voc,number=uncl,gender=uncl,inflection=0)	PD(type=dem,subtype=art,position=prenom,case=nom|dat|acc|voc,number=uncl,gender=uncl,inflection=0)
LID(bep,dial)	PD(type=dem,subtype=art,position=prenom,case=uncl,gender=uncl,number=uncl,inflection=uncl)	PD(type=dem,subtype=art,position=prenom,case=uncl,number=uncl,gender=uncl,inflection=uncl)
VNW(aanw,det,dat,prenom,met-e,evf)	PD(type=dem,case=dat,position=prenom,inflection=r/re,number=sg,gender=f)	PD(type=dem,subtype=oth,position=prenom,case=dat,number=sg,gender=f,inflection=r/re)
VNW(aanw,det,dat,prenom,met-e,evmo)	PD(type=dem,case=dat,position=prenom,inflection=n,number=sg,gender=m|n)	PD(type=dem,subtype=oth,position=prenom,case=dat,number=sg,gender=m|n,inflection=n)
VNW(aanw,det,gen,prenom,met-e,rest3)	PD(type=dem,case=gen,position=prenom,inflection=r/re,number=uncl,gender=uncl)	PD(type=dem,subtype=oth,position=prenom,case=gen,number=uncl,gender=uncl,inflection=r/re)
VNW(aanw,det,stan,prenom,zonder,evon)	PD(type=dem,case=nom|dat|acc|voc,position=prenom,inflection=0,number=sg,gender=n)	PD(type=dem,subtype=oth,position=prenom,case=nom|dat|acc|voc,number=sg,gender=n,inflection=0)
VNW(aanw,det,stan,prenom,zonder,agr)	PD(type=dem,case=nom|dat|acc|voc,position=prenom,inflection=0,number=uncl,gender=uncl)	PD(type=dem,subtype=oth,position=prenom,case=nom|dat|acc|voc,number=uncl,gender=uncl,inflection=0)
VNW(aanw,det,stan,prenom,zonder,rest)	PD(type=dem,case=nom|dat|acc|voc,position=prenom,inflection=0,number=uncl,gender=uncl)	PD(type=dem,subtype=oth,position=prenom,case=nom|dat|acc|voc,number=uncl,gender=uncl,inflection=0)
VNW(aanw,det,stan,prenom,met-e,rest)	PD(type=dem,case=nom|dat|acc|voc,position=prenom,inflection=0|e|n,number=uncl,gender=uncl)	PD(type=dem,subtype=oth,position=prenom,case=nom|dat|acc|voc,number=uncl,gender=uncl,inflection=0|e|n)
VZ(versm)[1]	PD(type=dem|indef,subtype=art,case=gen|dat,position=prenom,number=sg,gender=uncl)	PD(type=dem|indef,subtype=art,position=prenom,case=gen|dat,number=sg,gender=uncl,inflection=uncl)
VNW(excl,pron,stan,vol,3,getal)	PD(type=excl,case=nom|dat|acc|voc,position=free,number=uncl,gender=uncl,inflection=0)	PD(type=excl,position=free,case=nom|dat|acc|voc,number=uncl,gender=uncl,inflection=0)
VNW(excl,det,stan,vrij,zonder)	PD(type=excl,case=nom|dat|acc|voc,position=free,number=uncl,gender=uncl,inflection=0)	PD(type=excl,position=free,case=nom|dat|acc|voc,number=uncl,gender=uncl,inflection=0)
VNW(onbep,det,gen,nom,met-e,mv-n)	PD(type=indef,case=gen,position=free,number=pl,gender=uncl,inflection=r/re)	PD(type=indef,position=free,case=gen,number=pl,gender=uncl,inflection=r/re)
VNW(onbep,grad,gen,nom,met-e,mv-n,basis)	PD(type=indef,case=gen,position=free,inflection=r/re,number=pl,gender=uncl)	PD(type=indef,position=free,case=gen,number=pl,gender=uncl,inflection=r/re)
VNW(onbep,pron,gen,vol,3p,ev)	PD(type=indef,case=gen,number=sg,gender=uncl,position=free,inflection=s/th)	PD(type=indef,position=free,case=gen,number=sg,gender=uncl,inflection=s/th)
VNW(onbep,grad,stan,nom,met-e,mv-n,basis)	PD(type=indef,case=nom|dat|acc|voc,position=free,number=pl,gender=uncl,inflection=n)	PD(type=indef,position=free,case=nom|dat|acc|voc,number=pl,gender=uncl,inflection=n)
VNW(onbep,det,stan,nom,met-e,mv-n)	PD(type=indef,number=pl,gender=uncl,case=nom|dat|acc|voc,position=free,inflection=n)	PD(type=indef,position=free,case=nom|dat|acc|voc,number=pl,gender=uncl,inflection=n)
VNW(onbep,pron,stan,vol,3p,ev)	PD(type=indef,case=nom|dat|acc|voc,number=sg,gender=uncl,position=free,inflection=0)	PD(type=indef,position=free,case=nom|dat|acc|voc,number=sg,gender=uncl,inflection=0)
VNW(onbep,pron,stan,vol,3o,ev)	PD(type=indef,case=nom|dat|acc|voc,number=sg,gender=uncl,position=free,inflection=0)	PD(type=indef,position=free,case=nom|dat|acc|voc,number=sg,gender=uncl,inflection=0)
VNW(onbep,grad,stan,vrij,zonder,basis)	PD(type=indef,case=nom|dat|acc|voc,position=free,inflection=0,number=uncl,gender=uncl)	PD(type=indef,position=free,case=nom|dat|acc|voc,number=uncl,gender=uncl,inflection=0)
VNW(onbep,det,stan,vrij,zonder)	PD(type=indef,case=nom|dat|acc|voc,position=free,inflection=0,number=uncl,gender=uncl)	PD(type=indef,position=free,case=nom|dat|acc|voc,number=uncl,gender=uncl,inflection=0)
VNW(onbep,grad,stan,vrij,zonder,comp)	PD(type=indef,case=nom|dat|acc|voc,position=free,inflection=0,number=uncl,gender=uncl)	PD(type=indef,position=free,case=nom|dat|acc|voc,number=uncl,gender=uncl,inflection=0)
VNW(onbep,grad,stan,vrij,zonder,sup)	PD(type=indef,case=nom|dat|acc|voc,position=free,inflection=0,number=uncl,gender=uncl)	PD(type=indef,position=free,case=nom|dat|acc|voc,number=uncl,gender=uncl,inflection=0)
VNW(onbep,pron,dial)	PD(type=indef,position=free,case=uncl,number=uncl,gender=uncl,inflection=uncl)	PD(type=indef,position=free,case=uncl,number=uncl,gender=uncl,inflection=uncl)
VNW(onbep,det,dial)	PD(type=indef,position=uncl,case=uncl,number=uncl,gender=uncl,inflection=uncl)	PD(type=indef,position=uncl,case=uncl,number=uncl,gender=uncl,inflection=uncl)
LID(onbep,gen,evf)	PD(type=indef,subtype=art,position=prenom,case=gen,number=sg,gender=f,inflection=r/re)	PD(type=indef,subtype=art,position=prenom,case=gen,number=sg,gender=f,inflection=r/re)
LID(onbep,stan,agr)	PD(type=indef,subtype=art,position=prenom,case=nom|dat|acc|voc,number=uncl,gender=uncl,inflection=0)	PD(type=indef,subtype=art,position=prenom,case=nom|dat|acc|voc,number=uncl,gender=uncl,inflection=0)
LID(onbep,dial)	PD(type=indef,subtype=art,position=prenom,case=uncl,gender=uncl,number=uncl,inflection=uncl)	PD(type=indef,subtype=art,position=prenom,case=uncl,number=uncl,gender=uncl,inflection=uncl)
VNW(onbep,det,dat,prenom,met-e,evf)	PD(type=indef,case=dat,position=prenom,inflection=r/re,number=sg,gender=f)	PD(type=indef,subtype=oth,position=prenom,case=dat,number=sg,gender=f,inflection=r/re)
VNW(onbep,det,dat,prenom,met-e,evmo)	PD(type=indef,case=dat,position=prenom,inflection=n,number=sg,gender=m|n)	PD(type=indef,subtype=oth,position=prenom,case=dat,number=sg,gender=m|n,inflection=n)
VNW(onbep,det,gen,prenom,met-e,mv)	PD(type=indef,case=gen,position=prenom,inflection=r/re,number=pl,gender=uncl)	PD(type=indef,subtype=oth,position=prenom,case=gen,number=pl,gender=uncl,inflection=r/re)
VNW(onbep,det,stan,prenom,met-e,mv)	PD(type=indef,case=nom|dat|acc|voc,position=prenom,inflection=e,number=pl,gender=uncl)	PD(type=indef,subtype=oth,position=prenom,case=nom|dat|acc|voc,number=pl,gender=uncl,inflection=e)
VNW(onbep,det,stan,prenom,met-e,evz)	PD(type=indef,case=nom|dat|acc|voc,position=prenom,inflection=e,number=sg,gender=m|f)	PD(type=indef,subtype=oth,position=prenom,case=nom|dat|acc|voc,number=sg,gender=m|f,inflection=e)
VNW(onbep,det,stan,prenom,zonder,evon)	PD(type=indef,case=nom|dat|acc|voc,position=prenom,inflection=0,number=sg,gender=n)	PD(type=indef,subtype=oth,position=prenom,case=nom|dat|acc|voc,number=sg,gender=n,inflection=0)
VNW(onbep,grad,stan,prenom,zonder,agr,basis)	PD(type=indef,case=nom|dat|acc|voc,position=prenom,inflection=0,number=uncl,gender=uncl)	PD(type=indef,subtype=oth,position=prenom,case=nom|dat|acc|voc,number=uncl,gender=uncl,inflection=0)
VNW(onbep,grad,stan,prenom,zonder,agr,comp)	PD(type=indef,case=nom|dat|acc|voc,position=prenom,inflection=0,number=uncl,gender=uncl)	PD(type=indef,subtype=oth,position=prenom,case=nom|dat|acc|voc,number=uncl,gender=uncl,inflection=0)
VNW(onbep,det,stan,prenom,zonder,agr)	PD(type=indef,case=nom|dat|acc|voc,position=prenom,inflection=0,number=uncl,gender=uncl)	PD(type=indef,subtype=oth,position=prenom,case=nom|dat|acc|voc,number=uncl,gender=uncl,inflection=0)
VNW(onbep,grad,stan,prenom,met-e,agr,comp)	PD(type=indef,case=nom|dat|acc|voc,position=prenom,inflection=e,number=uncl,gender=uncl)	PD(type=indef,subtype=oth,position=prenom,case=nom|dat|acc|voc,number=uncl,gender=uncl,inflection=e)
VNW(onbep,det,stan,prenom,met-e,agr)	PD(type=indef,case=nom|dat|acc|voc,position=prenom,inflection=e,number=uncl,gender=uncl)	PD(type=indef,subtype=oth,position=prenom,case=nom|dat|acc|voc,number=uncl,gender=uncl,inflection=e)
VNW(onbep,grad,stan,prenom,met-e,agr,sup)	PD(type=indef,case=nom|dat|acc|voc,position=prenom,inflection=e,number=uncl,gender=uncl)	PD(type=indef,subtype=oth,position=prenom,case=nom|dat|acc|voc,number=uncl,gender=uncl,inflection=e)
VNW(onbep,det,stan,prenom,met-e,rest)	PD(type=indef,case=nom|dat|acc|voc,position=prenom,inflection=e,number=uncl,gender=uncl)	PD(type=indef,subtype=oth,position=prenom,case=nom|dat|acc|voc,number=uncl,gender=uncl,inflection=e)
VNW(onbep,grad,stan,prenom,met-e,agr,basis)	PD(type=indef,case=nom|dat|acc|voc,position=prenom,inflection=e,number=uncl,gender=uncl)	PD(type=indef,subtype=oth,position=prenom,case=nom|dat|acc|voc,number=uncl,gender=uncl,inflection=e)
VNW(vrag,pron,dial)	PD(type=inter,position=free,case=uncl,number=uncl,gender=uncl,inflection=uncl)	PD(type=inter,position=free,case=uncl,number=uncl,gender=uncl,inflection=uncl)
VNW(vrag,det,dial)	PD(type=inter,position=uncl,case=uncl,number=uncl,gender=uncl,inflection=uncl)	PD(type=inter,position=uncl,case=uncl,number=uncl,gender=uncl,inflection=uncl)
VNW(vb,pron,gen,vol,3p,mv)	PD(type=rel|inter,case=gen,number=pl,gender=uncl,position=free,inflection=r/re)	PD(type=inter|rel,position=free,case=gen,number=pl,gender=uncl,inflection=r/re)
VNW(vb,pron,gen,vol,3v,ev)	PD(type=rel|inter,case=gen,number=sg,gender=f,position=free,inflection=r/re)	PD(type=inter|rel,position=free,case=gen,number=sg,gender=f,inflection=r/re)
VNW(vb,pron,gen,vol,3m,ev)	PD(type=rel|inter,case=gen,number=sg,gender=m,position=free,inflection=s/th)	PD(type=inter|rel,position=free,case=gen,number=sg,gender=m,inflection=s/th)
VNW(vb,pron,stan,vol,3o,ev)	PD(type=rel|inter,case=nom|dat|acc|voc,number=sg,gender=uncl,position=free,inflection=0)	PD(type=inter|rel,position=free,case=nom|dat|acc|voc,number=sg,gender=uncl,inflection=0)
VNW(vb,pron,stan,vol,3p,getal)	PD(type=rel|inter,case=nom|dat|acc|voc,number=uncl,gender=uncl,position=free,inflection=0)	PD(type=inter|rel,position=free,case=nom|dat|acc|voc,number=uncl,gender=uncl,inflection=0)
VNW(vb,det,stan,nom,met-e,zonder-n)	PD(type=rel|inter,case=nom|dat|acc|voc,position=free,inflection=e,number=uncl,gender=uncl)	PD(type=inter|rel,position=free,case=nom|dat|acc|voc,number=uncl,gender=uncl,inflection=e)
VNW(vb,det,stan,prenom,zonder,evon)	PD(type=rel|inter,case=nom|dat|acc|voc,position=prenom,inflection=0,number=sg,gender=n)	PD(type=inter|rel,position=prenom,case=nom|dat|acc|voc,number=sg,gender=n,inflection=0)
VNW(vb,det,stan,prenom,met-e,rest)	PD(type=rel|inter,case=nom|dat|acc|voc,position=prenom,inflection=e,gender=uncl,number=uncl)	PD(type=inter|rel,position=prenom,case=nom|dat|acc|voc,number=uncl,gender=uncl,inflection=e)
VNW(pers,pron,stan,nadr,2v,mv)	PD(type=pers,case=dat|acc,LP=2,LN=pl,position=free,inflection=0)	PD(type=pers,position=free,case=dat|acc,LN=pl,LP=2,inflection=0)
VNW(pers,pron,stan,red,3,mv)	PD(type=pers,case=dat|acc,LP=3,LN=pl,position=free,inflection=0)	PD(type=pers,position=free,case=dat|acc,LN=pl,LP=3,inflection=0)
VNW(pers,pron,obl,vol,3p,mv)	PD(type=pers,case=dat|acc,LP=3,LN=pl,position=free,inflection=0)	PD(type=pers,position=free,case=dat|acc,LN=pl,LP=3,inflection=0)
VNW(pers,pron,obl,nadr,3p,mv)	PD(type=pers,case=dat|acc,LP=3,LN=pl,position=free,inflection=0)	PD(type=pers,position=free,case=dat|acc,LN=pl,LP=3,inflection=0)
VNW(pers,pron,obl,vol,2v,ev)	PD(type=pers,case=dat|acc,LP=2,LN=sg,position=free,inflection=0)	PD(type=pers,position=free,case=dat|acc,LN=sg,LP=2,inflection=0)
VNW(pers,pron,stan,red,3,ev,fem)	PD(type=pers,case=dat|acc,LP=3,LN=sg,LG=f,position=free,inflection=0)	PD(type=pers,position=free,case=dat|acc,LN=sg,LP=3,LG=f,inflection=0)
VNW(pers,pron,obl,vol,3,ev,masc)	PD(type=pers,case=dat|acc,LP=3,LN=sg,LG=m,position=free,inflection=0)	PD(type=pers,position=free,case=dat|acc,LN=sg,LP=3,LG=m,inflection=0)
VNW(pers,pron,obl,nadr,3m,ev,masc)	PD(type=pers,case=dat|acc,LP=3,LN=sg,LG=m,position=free,inflection=0)	PD(type=pers,position=free,case=dat|acc,LN=sg,LP=3,LG=m,inflection=0)
VNW(pers,pron,obl,red,3,ev,masc)	PD(type=pers,case=dat|acc,LP=3,LN=sg,LG=m,position=free,inflection=0)	PD(type=pers,position=free,case=dat|acc,LN=sg,LP=3,LG=m,inflection=0)
VNW(pers,pron,stan,red,3,ev,onz)	PD(type=pers,case=dat|acc,LP=3,LN=sg,LG=n,position=free,inflection=0)	PD(type=pers,position=free,case=dat|acc,LN=sg,LP=3,LG=n,inflection=0)
VNW(pers,pron,obl,red,3v,getal,fem)	PD(type=pers,case=dat|acc,LP=3,LN=uncl,LG=f,position=free,inflection=0)	PD(type=pers,position=free,case=dat|acc,LN=uncl,LP=3,LG=f,inflection=0)
VNW(pers,pron,obl,vol,3,getal,fem)	PD(type=pers,case=dat|acc,LP=3,LN=uncl,LG=f,position=free,inflection=0)	PD(type=pers,position=free,case=dat|acc,LN=uncl,LP=3,LG=f,inflection=0)
VNW(pers,pron,obl,nadr,3v,getal,fem)	PD(type=pers,case=dat|acc,LP=3,LN=uncl,LG=f,position=free,inflection=0)	PD(type=pers,position=free,case=dat|acc,LN=uncl,LP=3,LG=f,inflection=0)
VNW(pers,pron,gen,vol,1,mv)	PD(type=pers,case=gen,LP=1,LN=pl,position=free,inflection=r/re|s/th)	PD(type=pers,position=free,case=gen,LN=pl,LP=1,inflection=r/re|s/th)
VNW(pers,pron,gen,vol,3p,mv)	PD(type=pers,case=gen,LP=3,LN=pl,position=free,inflection=r/re|s/th)	PD(type=pers,position=free,case=gen,LN=pl,LP=3,inflection=r/re|s/th)
VNW(pers,pron,gen,vol,1,ev)	PD(type=pers,case=gen,LP=1,LN=sg,position=free,inflection=r/re|s/th)	PD(type=pers,position=free,case=gen,LN=sg,LP=1,inflection=r/re|s/th)
VNW(pers,pron,gen,vol,3m,ev)	PD(type=pers,case=gen,LP=3,LN=sg,position=free,inflection=r/re|s/th)	PD(type=pers,position=free,case=gen,LN=sg,LP=3,LG=uncl,inflection=r/re|s/th)
VNW(pers,pron,gen,vol,2,getal)	PD(type=pers,case=gen,LP=2,LN=uncl,position=free,inflection=r/re|s/th)	PD(type=pers,position=free,case=gen,LN=uncl,LP=2,inflection=r/re|s/th)
VNW(onbep,adv-pron,gen,red,3,getal)	PD(type=pers,case=gen,inflection=0,position=free,LP=3,LN=uncl,LG=uncl)	PD(type=pers,position=free,case=gen,LN=uncl,LP=3,LG=uncl,inflection=0)
VNW(pers,pron,gen,vol,3v,getal)	PD(type=pers,case=gen,LP=3,LN=uncl,position=free,inflection=r/re|s/th)	PD(type=pers,position=free,case=gen,LN=uncl,LP=3,LG=uncl,inflection=r/re|s/th)
VNW(pers,pron,nomin,nadr,1,mv)	PD(type=pers,case=nom|voc,LP=1,LN=pl,position=free,inflection=0)	PD(type=pers,position=free,case=nom|voc,LN=pl,LP=1,inflection=0)
VNW(pers,pron,nomin,vol,1,mv)	PD(type=pers,case=nom|voc,LP=1,LN=pl,position=free,inflection=0)	PD(type=pers,position=free,case=nom|voc,LN=pl,LP=1,inflection=0)
VNW(pers,pron,nomin,red,1,mv)	PD(type=pers,case=nom|voc,LP=1,LN=pl,position=free,inflection=0)	PD(type=pers,position=free,case=nom|voc,LN=pl,LP=1,inflection=0)
VNW(pers,pron,nomin,vol,3p,mv)	PD(type=pers,case=nom|voc,LP=3,LN=pl,position=free,inflection=0)	PD(type=pers,position=free,case=nom|voc,LN=pl,LP=3,inflection=0)
VNW(pers,pron,nomin,nadr,3p,mv)	PD(type=pers,case=nom|voc,LP=3,LN=pl,position=free,inflection=0)	PD(type=pers,position=free,case=nom|voc,LN=pl,LP=3,inflection=0)
VNW(pers,pron,nomin,vol,1,ev)	PD(type=pers,case=nom|voc,LP=1,LN=sg,position=free,inflection=0)	PD(type=pers,position=free,case=nom|voc,LN=sg,LP=1,inflection=0)
VNW(pers,pron,nomin,red,1,ev)	PD(type=pers,case=nom|voc,LP=1,LN=sg,position=free,inflection=0)	PD(type=pers,position=free,case=nom|voc,LN=sg,LP=1,inflection=0)
VNW(pers,pron,nomin,nadr,1,ev)	PD(type=pers,case=nom|voc,LP=1,LN=sg,position=free,inflection=0|e)	PD(type=pers,position=free,case=nom|voc,LN=sg,LP=1,inflection=0|e)
VNW(pers,pron,nomin,nadr,2v,ev)	PD(type=pers,case=nom|voc,LP=2,LN=sg,position=free,inflection=0)	PD(type=pers,position=free,case=nom|voc,LN=sg,LP=2,inflection=0)
VNW(pers,pron,nomin,vol,2v,ev)	PD(type=pers,case=nom|voc,LP=2,LN=sg,position=free,inflection=0)	PD(type=pers,position=free,case=nom|voc,LN=sg,LP=2,inflection=0)
VNW(pers,pron,nomin,red,2v,ev)	PD(type=pers,case=nom|voc,LP=2,LN=sg,position=free,inflection=0)	PD(type=pers,position=free,case=nom|voc,LN=sg,LP=2,inflection=0)
VNW(pers,pron,nomin,vol,3v,ev,fem)	PD(type=pers,case=nom|voc,LP=3,LN=sg,LG=f,position=free,inflection=0)	PD(type=pers,position=free,case=nom|voc,LN=sg,LP=3,LG=f,inflection=0)
VNW(pers,pron,nomin,nadr,3v,ev,fem)	PD(type=pers,case=nom|voc,LP=3,LN=sg,LG=f,position=free,inflection=0)	PD(type=pers,position=free,case=nom|voc,LN=sg,LP=3,LG=f,inflection=0)
VNW(pers,pron,nomin,red,3p,ev,masc)	PD(type=pers,case=nom|voc,LP=3,LN=sg,LG=m,position=free,inflection=0)	PD(type=pers,position=free,case=nom|voc,LN=sg,LP=3,LG=m,inflection=0)
VNW(pers,pron,nomin,vol,3,ev,masc)	PD(type=pers,case=nom|voc,LP=3,LN=sg,LG=m,position=free,inflection=0)	PD(type=pers,position=free,case=nom|voc,LN=sg,LP=3,LG=m,inflection=0)
VNW(pers,pron,nomin,red,3,ev,masc)	PD(type=pers,case=nom|voc,LP=3,LN=sg,LG=m,position=free,inflection=0)	PD(type=pers,position=free,case=nom|voc,LN=sg,LP=3,LG=m,inflection=0)
VNW(pers,pron,nomin,nadr,3m,ev,masc)	PD(type=pers,case=nom|voc,LP=3,LN=sg,LG=m,position=free,inflection=0)	PD(type=pers,position=free,case=nom|voc,LN=sg,LP=3,LG=m,inflection=0)
VNW(pers,pron,nomin,nadr,2,getal)	PD(type=pers,case=nom|voc,LP=2,LN=uncl,position=free,inflection=0)	PD(type=pers,position=free,case=nom|voc,LN=uncl,LP=2,inflection=0)
VNW(pers,pron,nomin,vol,2,getal)	PD(type=pers,case=nom|voc,LP=2,LN=uncl,position=free,inflection=0)	PD(type=pers,position=free,case=nom|voc,LN=uncl,LP=2,inflection=0)
VNW(pers,pron,nomin,vol,2b,getal)	PD(type=pers,case=nom|voc,LP=2,LN=uncl,position=free,inflection=0)	PD(type=pers,position=free,case=nom|voc,LN=uncl,LP=2,inflection=0)
VNW(pers,pron,nomin,red,2,getal)	PD(type=pers,case=nom|voc,LP=2,LN=uncl,position=free,inflection=0)	PD(type=pers,position=free,case=nom|voc,LN=uncl,LP=2,inflection=0)
VNW(pers,pron,nomin,nadr,2b,getal)	PD(type=pers,case=nom|voc,LP=2,LN=uncl,position=free,inflection=0)	PD(type=pers,position=free,case=nom|voc,LN=uncl,LP=2,inflection=0)
VNW(pers,pron,dial)	PD(type=pers,position=free,case=uncl,LP=uncl,LN=uncl,LG=uncl,inflection=uncl)	PD(type=pers,position=free,case=uncl,LN=uncl,LP=uncl,LG=uncl,inflection=uncl)
VNW(pr,pron,obl,nadr,1,mv)	PD(type=pers|refl,case=dat|acc,LP=1,LN=pl,position=free,inflection=0)	PD(type=pers|refl,position=free,case=dat|acc,LN=pl,LP=1,inflection=0)
VNW(pr,pron,obl,vol,1,mv)	PD(type=pers|refl,case=dat|acc,LP=1,LN=pl,position=free,inflection=0)	PD(type=pers|refl,position=free,case=dat|acc,LN=pl,LP=1,inflection=0)
VNW(pr,pron,obl,red,1,ev)	PD(type=pers|refl,case=dat|acc,LP=1,LN=sg,position=free,inflection=0)	PD(type=pers|refl,position=free,case=dat|acc,LN=sg,LP=1,inflection=0)
VNW(pr,pron,obl,vol,1,ev)	PD(type=pers|refl,case=dat|acc,LP=1,LN=sg,position=free,inflection=0)	PD(type=pers|refl,position=free,case=dat|acc,LN=sg,LP=1,inflection=0)
VNW(pr,pron,obl,nadr,1,ev)	PD(type=pers|refl,case=dat|acc,LP=1,LN=sg,position=free,inflection=0)	PD(type=pers|refl,position=free,case=dat|acc,LN=sg,LP=1,inflection=0)
VNW(pr,pron,obl,nadr,2,getal)	PD(type=pers|refl,case=dat|acc,LP=2,LN=uncl,position=free,inflection=0)	PD(type=pers|refl,position=free,case=dat|acc,LN=uncl,LP=2,inflection=0)
VNW(pr,pron,obl,nadr,2v,getal)	PD(type=pers|refl,case=dat|acc,LP=2,LN=uncl,position=free,inflection=0)	PD(type=pers|refl,position=free,case=dat|acc,LN=uncl,LP=2,inflection=0)
VNW(pr,pron,obl,vol,2,getal)	PD(type=pers|refl,case=dat|acc,LP=2,LN=uncl,position=free,inflection=0)	PD(type=pers|refl,position=free,case=dat|acc,LN=uncl,LP=2,inflection=0)
VNW(pr,pron,obl,red,2v,getal)	PD(type=pers|refl,case=dat|acc,LP=2,LN=uncl,position=free,inflection=0)	PD(type=pers|refl,position=free,case=dat|acc,LN=uncl,LP=2,inflection=0)
VNW(bez,det,dat,vol,1,mv,prenom,met-e,evf)	PD(type=poss,case=dat,LP=1,LN=pl,position=prenom,inflection=r/re,number=sg,gender=f)	PD(type=poss,position=prenom,case=dat,LN=pl,LP=1,number=sg,gender=f,inflection=r/re)
VNW(bez,det,dat,vol,1,mv,prenom,met-e,evmo)	PD(type=poss,case=dat,LP=1,LN=pl,position=prenom,inflection=n,number=sg,gender=m|n)	PD(type=poss,position=prenom,case=dat,LN=pl,LP=1,number=sg,gender=m|n,inflection=n)
VNW(bez,det,dat,vol,3p,mv,prenom,met-e,evf)	PD(type=poss,case=dat,LP=3,LN=pl,position=prenom,inflection=r/re,number=sg,gender=f)	PD(type=poss,position=prenom,case=dat,LN=pl,LP=3,number=sg,gender=f,inflection=r/re)
VNW(bez,det,dat,vol,3p,mv,prenom,met-e,evmo)	PD(type=poss,case=dat,LP=3,LN=pl,position=prenom,inflection=n,number=sg,gender=m|n)	PD(type=poss,position=prenom,case=dat,LN=pl,LP=3,number=sg,gender=m|n,inflection=n)
VNW(bez,det,dat,vol,1,ev,prenom,met-e,evf)	PD(type=poss,case=dat,LP=1,LN=sg,position=prenom,inflection=r/re,gender=f,number=sg)	PD(type=poss,position=prenom,case=dat,LN=sg,LP=1,number=sg,gender=f,inflection=r/re)
VNW(bez,det,dat,vol,1,ev,prenom,met-e,evmo)	PD(type=poss,case=dat,LP=1,LN=sg,position=prenom,inflection=n,gender=m|n,number=sg)	PD(type=poss,position=prenom,case=dat,LN=sg,LP=1,number=sg,gender=m|n,inflection=n)
VNW(bez,det,dat,vol,2v,ev,prenom,met-e,evf)	PD(type=poss,case=dat,LP=2,LN=sg,position=prenom,inflection=r/re,number=sg,gender=f)	PD(type=poss,position=prenom,case=dat,LN=sg,LP=2,number=sg,gender=f,inflection=r/re)
VNW(bez,det,dat,vol,3v,ev,prenom,met-e,evf)	PD(type=poss,case=dat,LP=3,LG=f,LN=sg,position=prenom,inflection=r/re,number=sg,gender=f)	PD(type=poss,position=prenom,case=dat,LN=sg,LP=3,LG=f,number=sg,gender=f,inflection=r/re)
VNW(bez,det,dat,vol,3v,ev,prenom,met-e,evmo)	PD(type=poss,case=dat,LP=3,LG=f,LN=sg,position=prenom,inflection=n,number=sg,gender=m|n)	PD(type=poss,position=prenom,case=dat,LN=sg,LP=3,LG=f,number=sg,gender=m|n,inflection=n)
VNW(bez,det,dat,vol,3,ev,prenom,met-e,evf)	PD(type=poss,case=dat,LP=3,LG=uncl,LN=sg,position=prenom,inflection=r/re,number=sg,gender=f)	PD(type=poss,position=prenom,case=dat,LN=sg,LP=3,LG=uncl,number=sg,gender=f,inflection=r/re)
VNW(bez,det,dat,vol,3,ev,prenom,met-e,evmo)	PD(type=poss,case=dat,LP=3,LG=uncl,LN=sg,position=prenom,inflection=n,number=sg,gender=m|n)	PD(type=poss,position=prenom,case=dat,LN=sg,LP=3,LG=uncl,number=sg,gender=m|n,inflection=n)
VNW(bez,det,dat,vol,2,getal,prenom,met-e,evf)	PD(type=poss,case=dat,LP=2,LN=uncl,position=prenom,inflection=r/re,number=sg,gender=f)	PD(type=poss,position=prenom,case=dat,LN=uncl,LP=2,number=sg,gender=f,inflection=r/re)
VNW(bez,det,dat,vol,2,getal,prenom,met-e,evmo)	PD(type=poss,case=dat,LP=2,LN=uncl,position=prenom,inflection=n,number=sg,gender=m|n)	PD(type=poss,position=prenom,case=dat,LN=uncl,LP=2,number=sg,gender=m|n,inflection=n)
VNW(bez,det,gen,vol,1,mv,prenom,met-e,evmo)	PD(type=poss,case=gen,LP=1,LN=pl,position=prenom,inflection=s/th,gender=m|n,number=sg)	PD(type=poss,position=prenom,case=gen,LN=pl,LP=1,number=sg,gender=m|n,inflection=s/th)
VNW(bez,det,gen,vol,1,mv,prenom,met-e,rest3)	PD(type=poss,case=gen,LP=1,LN=pl,position=prenom,inflection=r/re,gender=uncl,number=uncl)	PD(type=poss,position=prenom,case=gen,LN=pl,LP=1,number=uncl,gender=uncl,inflection=r/re)
VNW(bez,det,gen,vol,3p,mv,prenom,zonder,evmo)	PD(type=poss,case=gen,LP=3,LN=pl,position=prenom,inflection=s/th,number=sg,gender=m|n)	PD(type=poss,position=prenom,case=gen,LN=pl,LP=3,number=sg,gender=m|n,inflection=s/th)
VNW(bez,det,gen,vol,3p,mv,prenom,met-e,rest3)	PD(type=poss,case=gen,LP=3,LN=pl,position=prenom,inflection=r/re,gender=uncl,number=uncl)	PD(type=poss,position=prenom,case=gen,LN=pl,LP=3,number=uncl,gender=uncl,inflection=r/re)
VNW(bez,det,gen,vol,1,ev,prenom,zonder,evmo)	PD(type=poss,case=gen,LP=1,LN=sg,position=prenom,inflection=s/th,gender=m|n,number=sg)	PD(type=poss,position=prenom,case=gen,LN=sg,LP=1,number=sg,gender=m|n,inflection=s/th)
VNW(bez,det,gen,vol,1,ev,prenom,met-e,rest3)	PD(type=poss,case=gen,LP=1,LN=sg,position=prenom,inflection=r/re,gender=uncl,number=uncl)	PD(type=poss,position=prenom,case=gen,LN=sg,LP=1,number=uncl,gender=uncl,inflection=r/re)
VNW(bez,det,gen,vol,2v,ev,prenom,met-e,rest3)	PD(type=poss,case=gen,LP=2,LN=sg,position=prenom,inflection=r/re,gender=uncl,number=uncl)	PD(type=poss,position=prenom,case=gen,LN=sg,LP=2,number=uncl,gender=uncl,inflection=r/re)
VNW(bez,det,gen,vol,3v,ev,prenom,zonder,evmo)	PD(type=poss,case=gen,LP=3,LG=f,LN=sg,position=prenom,inflection=s/th,gender=m|n,number=sg)	PD(type=poss,position=prenom,case=gen,LN=sg,LP=3,LG=f,number=sg,gender=m|n,inflection=s/th)
VNW(bez,det,gen,vol,3v,ev,prenom,met-e,rest3)	PD(type=poss,case=gen,LP=3,LG=f,LN=sg,position=prenom,inflection=r/re,gender=uncl,number=uncl)	PD(type=poss,position=prenom,case=gen,LN=sg,LP=3,LG=f,number=uncl,gender=uncl,inflection=r/re)
VNW(bez,det,gen,vol,3,ev,prenom,zonder,evmo)	PD(type=poss,case=gen,LP=3,LG=uncl,LN=sg,position=prenom,inflection=s/th,number=sg,gender=uncl)	PD(type=poss,position=prenom,case=gen,LN=sg,LP=3,LG=uncl,number=sg,gender=uncl,inflection=s/th)
VNW(bez,det,gen,vol,3,ev,prenom,met-e,rest3)	PD(type=poss,case=gen,LP=3,LG=uncl,LN=sg,position=prenom,inflection=r/re,gender=uncl,number=uncl)	PD(type=poss,position=prenom,case=gen,LN=sg,LP=3,LG=uncl,number=uncl,gender=uncl,inflection=r/re)
VNW(bez,det,gen,vol,2,getal,prenom,zonder,evmo)	PD(type=poss,case=gen,LP=2,LN=uncl,position=prenom,inflection=s/th,gender=m|n,number=sg)	PD(type=poss,position=prenom,case=gen,LN=uncl,LP=2,number=sg,gender=m|n,inflection=s/th)
VNW(bez,det,gen,vol,2,getal,prenom,met-e,rest3)	PD(type=poss,case=gen,LP=2,LN=uncl,position=prenom,inflection=r/re,gender=uncl,number=uncl)	PD(type=poss,position=prenom,case=gen,LN=uncl,LP=2,number=uncl,gender=uncl,inflection=r/re)
VNW(bez,det,stan,vol,1,mv,prenom,zonder,evon)	PD(type=poss,case=nom|dat|acc|voc,LP=1,LN=pl,position=prenom,inflection=0,gender=n,number=sg)	PD(type=poss,position=prenom,case=nom|dat|acc|voc,LN=pl,LP=1,number=sg,gender=n,inflection=0)
VNW(bez,det,stan,vol,1,mv,prenom,met-e,rest)	PD(type=poss,case=nom|dat|acc|voc,LP=1,LN=pl,position=prenom,inflection=e,gender=uncl,number=uncl)	PD(type=poss,position=prenom,case=nom|dat|acc|voc,LN=pl,LP=1,number=uncl,gender=uncl,inflection=e)
VNW(bez,det,stan,nadr,2v,mv,prenom,zonder,agr)	PD(type=poss,case=nom|dat|acc|voc,LP=2,LN=pl,position=prenom,inflection=0,gender=uncl,number=uncl)	PD(type=poss,position=prenom,case=nom|dat|acc|voc,LN=pl,LP=2,number=uncl,gender=uncl,inflection=0)
VNW(bez,det,stan,vol,3,mv,prenom,zonder,agr)	PD(type=poss,case=nom|dat|acc|voc,LP=3,LN=pl,position=prenom,inflection=0,gender=uncl,number=uncl)	PD(type=poss,position=prenom,case=nom|dat|acc|voc,LN=pl,LP=3,number=uncl,gender=uncl,inflection=0)
VNW(bez,det,stan,vol,3p,mv,prenom,met-e,rest)	PD(type=poss,case=nom|dat|acc|voc,LP=3,LN=pl,position=prenom,inflection=e,gender=uncl,number=uncl)	PD(type=poss,position=prenom,case=nom|dat|acc|voc,LN=pl,LP=3,number=uncl,gender=uncl,inflection=e)
VNW(bez,det,stan,red,1,ev,prenom,zonder,agr)	PD(type=poss,case=nom|dat|acc|voc,LP=1,LN=sg,position=prenom,inflection=0,gender=uncl,number=uncl)	PD(type=poss,position=prenom,case=nom|dat|acc|voc,LN=sg,LP=1,number=uncl,gender=uncl,inflection=0)
VNW(bez,det,stan,vol,1,ev,prenom,zonder,agr)	PD(type=poss,case=nom|dat|acc|voc,LP=1,LN=sg,position=prenom,inflection=0,gender=uncl,number=uncl)	PD(type=poss,position=prenom,case=nom|dat|acc|voc,LN=sg,LP=1,number=uncl,gender=uncl,inflection=0)
VNW(bez,det,stan,vol,1,ev,prenom,met-e,rest)	PD(type=poss,case=nom|dat|acc|voc,LP=1,LN=sg,position=prenom,inflection=e,gender=uncl,number=uncl)	PD(type=poss,position=prenom,case=nom|dat|acc|voc,LN=sg,LP=1,number=uncl,gender=uncl,inflection=e)
VNW(bez,det,stan,vol,2v,ev,prenom,zonder,agr)	PD(type=poss,case=nom|dat|acc|voc,LP=2,LN=sg,position=prenom,inflection=0,gender=uncl,number=uncl)	PD(type=poss,position=prenom,case=nom|dat|acc|voc,LN=sg,LP=2,number=uncl,gender=uncl,inflection=0)
VNW(bez,det,stan,red,2v,ev,prenom,zonder,agr)	PD(type=poss,case=nom|dat|acc|voc,LP=2,LN=sg,position=prenom,inflection=0,gender=uncl,number=uncl)	PD(type=poss,position=prenom,case=nom|dat|acc|voc,LN=sg,LP=2,number=uncl,gender=uncl,inflection=0)
VNW(bez,det,stan,vol,3v,ev,prenom,met-e,rest)	PD(type=poss,case=nom|dat|acc|voc,LP=3,LG=f,LN=sg,position=prenom,inflection=e,gender=uncl,number=uncl)	PD(type=poss,position=prenom,case=nom|dat|acc|voc,LN=sg,LP=3,LG=f,number=uncl,gender=uncl,inflection=e)
VNW(bez,det,stan,vol,3m,ev,prenom,met-e,rest)	PD(type=poss,case=nom|dat|acc|voc,LP=3,LG=m,LN=sg,position=prenom,inflection=e,gender=uncl,number=uncl)	PD(type=poss,position=prenom,case=nom|dat|acc|voc,LN=sg,LP=3,LG=m,number=uncl,gender=uncl,inflection=e)
VNW(bez,det,stan,vol,3,ev,prenom,zonder,agr)	PD(type=poss,case=nom|dat|acc|voc,LP=3,LG=uncl,LN=sg,position=prenom,inflection=0,gender=uncl,number=uncl)	PD(type=poss,position=prenom,case=nom|dat|acc|voc,LN=sg,LP=3,LG=uncl,number=uncl,gender=uncl,inflection=0)
VNW(bez,det,stan,red,3,ev,prenom,zonder,agr)	PD(type=poss,case=nom|dat|acc|voc,LP=3,LG=uncl,LN=sg,position=prenom,inflection=0,gender=uncl,number=uncl)	PD(type=poss,position=prenom,case=nom|dat|acc|voc,LN=sg,LP=3,LG=uncl,number=uncl,gender=uncl,inflection=0)
VNW(bez,det,stan,vol,2,getal,prenom,zonder,agr)	PD(type=poss,case=nom|dat|acc|voc,LP=2,LN=uncl,position=prenom,inflection=0,gender=uncl,number=uncl)	PD(type=poss,position=prenom,case=nom|dat|acc|voc,LN=uncl,LP=2,number=uncl,gender=uncl,inflection=0)
VNW(bez,det,stan,vol,2,getal,prenom,met-e,rest)	PD(type=poss,case=nom|dat|acc|voc,LP=2,LN=uncl,position=prenom,inflection=e,gender=uncl,number=uncl)	PD(type=poss,position=prenom,case=nom|dat|acc|voc,LN=uncl,LP=2,number=uncl,gender=uncl,inflection=e)
VNW(bez,det,stan,red,3,getal,prenom,zonder,agr)	PD(type=poss,case=nom|dat|acc|voc,LP=3,LN=uncl,position=prenom,inflection=0,gender=uncl,number=uncl)	PD(type=poss,position=prenom,case=nom|dat|acc|voc,LN=uncl,LP=3,number=uncl,gender=uncl,inflection=0)
VNW(bez,det,dial)	PD(type=poss,position=prenom,case=uncl,LP=uncl,LN=uncl,LG=uncl,number=uncl,gender=uncl,inflection=uncl)	PD(type=poss,position=prenom,case=uncl,LN=uncl,LP=uncl,LG=uncl,number=uncl,gender=uncl,inflection=uncl)
VNW(recip,pron,obl,vol,persoon,mv)	PD(type=recip,case=dat|acc,LN=pl,LP=3,position=free,inflection=0)	PD(type=recip,position=free,case=dat|acc,LN=pl,LP=3,inflection=0)
VNW(recip,pron,gen,vol,persoon,mv)	PD(type=recip,case=gen,LN=pl,LP=3,position=free,inflection=s/th)	PD(type=recip,position=free,case=gen,LN=pl,LP=3,inflection=s/th)
VNW(recip,pron,dial)	PD(type=recip,position=free,case=uncl,LP=uncl,LN=pl,inflection=uncl)	PD(type=recip,position=free,case=uncl,LN=pl,LP=uncl,inflection=uncl)
VNW(refl,pron,obl,nadr,3,getal)	PD(type=refl,case=dat|acc,LP=3,LN=uncl,LG=uncl,position=free,inflection=0)	PD(type=refl,position=free,case=dat|acc,LN=uncl,LP=3,LG=uncl,inflection=0)
VNW(refl,pron,obl,red,3,getal)	PD(type=refl,case=dat|acc,LP=3,LN=uncl,LG=uncl,position=free,inflection=0)	PD(type=refl,position=free,case=dat|acc,LN=uncl,LP=3,LG=uncl,inflection=0)
VNW(refl,pron,dial)	PD(type=refl,position=free,case=uncl,LP=uncl,LN=uncl,LG=uncl,inflection=uncl)	PD(type=refl,position=free,case=uncl,LN=uncl,LP=uncl,LG=uncl,inflection=uncl)
VNW(betr,pron,gen,vol,3o,ev)	PD(type=rel,case=gen,number=sg,gender=uncl,position=free,inflection=s/th)	PD(type=rel,position=free,case=gen,number=sg,gender=uncl,inflection=s/th)
VNW(betr,pron,gen,vol,3o,getal)	PD(type=rel,case=gen,number=uncl,gender=uncl,position=free,inflection=r/re)	PD(type=rel,position=free,case=gen,number=uncl,gender=uncl,inflection=r/re)
VNW(betr,pron,stan,vol,3,ev)	PD(type=rel,case=nom|dat|acc|voc,number=sg,gender=uncl,position=free,inflection=0)	PD(type=rel,position=free,case=nom|dat|acc|voc,number=sg,gender=uncl,inflection=0)
VNW(betr,pron,stan,vol,persoon,getal)	PD(type=rel,case=nom|dat|acc|voc,number=uncl,gender=uncl,position=free,inflection=0)	PD(type=rel,position=free,case=nom|dat|acc|voc,number=uncl,gender=uncl,inflection=0)
VNW(betr,det,stan,nom,zonder,zonder-n)	PD(type=rel,case=nom|dat|acc|voc,number=uncl,gender=uncl,position=free,inflection=0)	PD(type=rel,position=free,case=nom|dat|acc|voc,number=uncl,gender=uncl,inflection=0)
VNW(betr,det,stan,nom,met-e,zonder-n)	PD(type=rel,case=nom|dat|acc|voc,number=uncl,gender=uncl,position=free,inflection=e)	PD(type=rel,position=free,case=nom|dat|acc|voc,number=uncl,gender=uncl,inflection=e)
VNW(betr,pron,dial)	PD(type=rel,position=free,case=uncl,number=uncl,gender=uncl,inflection=uncl)	PD(type=rel,position=free,case=uncl,number=uncl,gender=uncl,inflection=uncl)
VNW(betr,det,dial)	PD(type=rel,position=free,case=uncl,number=uncl,gender=uncl,inflection=uncl)	PD(type=rel,position=free,case=uncl,number=uncl,gender=uncl,inflection=uncl)
SPEC(vreemd)	RES(type=for)	RES(type=for,WF=uncl)
SPEC(meta)	RES(type=meta)	RES(type=meta,WF=uncl)
SPEC(afk)	RES(type=oth,WF=abbr)	RES(type=oth,WF=abbr)
SPEC(symb)	RES(type=symb)	RES(type=symb,WF=uncl)
SPEC(afgebr)	RES(type=uncl,WF=trunc)	RES(type=uncl,WF=trunc)
SPEC(onverst)	RES(type=uncl)	RES(type=uncl,WF=uncl)
SPEC(achter)	RM	RM()
SPEC(comment)	RM	RM()
WW(pv,verl,mv)	VRB(finiteness=fin,mood=ind,tense=past,number=pl,inflection=n)	VRB(finiteness=fin,tense=past,mood=ind,number=pl,inflection=n)
WW(pv,verl,ev)	VRB(finiteness=fin,mood=ind,tense=past,number=sg,inflection=0|e)	VRB(finiteness=fin,tense=past,mood=ind,number=sg,inflection=0|e)
WW(pv,verl,met-t)	VRB(finiteness=fin,mood=ind,tense=past,number=sg,inflection=t)	VRB(finiteness=fin,tense=past,mood=ind,number=sg,inflection=t)
WW(pv,tgw,mv)	VRB(finiteness=fin,mood=ind,tense=pres,number=pl,inflection=n)	VRB(finiteness=fin,tense=pres,mood=ind,number=pl,inflection=n)
WW(pv,tgw,ev)	VRB(finiteness=fin,mood=ind|imp,tense=pres,number=sg,inflection=0)	VRB(finiteness=fin,tense=pres,mood=ind|imp,number=sg,inflection=0)
WW(pv,tgw,met-t)	VRB(finiteness=fin,mood=ind|imp,tense=pres,number=sg,inflection=t)	VRB(finiteness=fin,tense=pres,mood=ind|imp,number=sg,inflection=t)
WW(pv,conj,ev)	VRB(finiteness=fin,mood=conj,tense=uncl,number=sg,inflection=e)	VRB(finiteness=fin,tense=uncl,mood=conj,number=sg,inflection=e)
WW(inf,prenom,zonder)	VRB(finiteness=inf,inflection=0)	VRB(finiteness=inf,inflection=0)
WW(inf,vrij,zonder)	VRB(finiteness=inf,inflection=0)	VRB(finiteness=inf,inflection=0)
WW(inf,prenom,met-e)	VRB(finiteness=inf,inflection=e)	VRB(finiteness=inf,inflection=e)
WW(vd,vrij,zonder)	VRB(finiteness=pastpart,inflection=0)	VRB(finiteness=pastpart,inflection=0)
WW(od,vrij,zonder)	VRB(finiteness=prespart,inflection=0|e)	VRB(finiteness=prespart,inflection=0|e)
WW(dial)	VRB(finiteness=uncl,tense=uncl,mood=uncl,number=uncl,inflection=uncl)	VRB(finiteness=uncl,tense=uncl,mood=uncl,number=uncl,inflection=uncl)
